gierig: жадный, алчный
traube: киcть/гроздь (винограда, смородины...)
kerl: чувак
kumpel: дружбан
trinkflasche: фляга
#flachmann: фляжка для спиртного
melone: дыня
hahn: петух
kamm: расческа
eigelb: яичный желток
reißen: рвать, разрывать, с sich - порезаться/пораниться 
streicheln: гладить(кошку), поглаживание
#Местоимения, дательный падеж, Dativ
mir: мне
dir: тебе
ihm: ему
ihr: ей
uns: наc, нам
euch: вам, вас (множественное число на ты)
ihnen: им, Вам 
#Местоимения, винительный падеж, Akkusativ
mich: меня
dich: тебя
ihn: его (м. род)
es: его (ср.род)
sie: их, её, Вас
#Приветствия, прощания, восклицания
hallo: привет! [повседневное приветствие]
vorsicht:осторожность, осторожно!
willkommen: добро пожаловать!
gerne: охотно! с удовольствием!
bitte: просьба, пожалуйста!
tschüss: пока! 
danke: спасибо!
aufwiederhören: услышимся!
achtung: внимание!
#Время #1
aufwiedersehen: до встречи!
zeit: время
sekunde: секунда
datum: дата, число
moment: момент
jahr: год
jahrhundert: столетие
jahrzehnt: десятилетие
morgen: утро, завтра
monat: месяц
vormittag: первая половина дня
woche: неделя
mittag: полдень
tag: день
nachmittag: вторая половина дня
stunde: час, урок
abend: вечер
abends: по вечерам
minute: минута
#Время #2
nacht: ночь
anfangen: начинать, начинаться
sofort: сейчас же
dauern: длиться
heute: сегодня
enden: заканчивать, оканчиваться
gerade: прямо сейчас, только что
nie: никогда
zurzeit: в этот момент, прямо сейчас
einmal: один раз, однажды
jetzt: теперь, сейчас
oft: часто
schon: уже
immer: всегда
seit: с [даты, времени]
früher: раньше
spät: поздно
gestern: вчера
#Дни недели
bald: скоро
wochentag: день недели
freitag: пятница
montag: понедельник
wochenende: выходные
dienstag: вторник
samstag: суббота
mittwoch: среда
sonntag: воскресенье
#Времена года и месяца
donnerstag: четверг
frühling: весна
mai: май
sommer: лето
juni: июнь
herbst: осень
juli: июль
winter: зима
august: август
januar: январь
september: сентябрь
februar: февраль
oktober: октябрь
märz: март
november: ноябрь
april: апрель
#Цифры и числа
dezember: декабрь
eins: раз! один! (при счете)
hundert: сотня
tausend: тысяча
million: миллион
milliarde: миллиард
#Меры длины и веса
meter: метр
liter: литр
zentimeter: сантиметр
gramm: грамм
quadratmeter: квадратный метр
kilogramm: килограмм
prozent: процент
#Количество
pfund: фунт
circa: примерно, приблизительно
mehr: больше
bisschen: немного
#Цвета
wenig: мало
schwarz: чёрный
grün: зелёный
weiß: белый
rot: красный
grau: серый
gelb: жёлтый
blau: синий
#Вопросительные слова
braun: коричневый
wer: кто?
warum: почему?
was: что?
woher: откуда?
wo: где, где?
wohin: куда?
wie: как?
wieviel: как много?
wann: когда?
#География, направления, стороны света
wasfürein: что за? какой?
welt: мир
land: страна
geradeaus: прямо (направление)
stadt: город
zurück: назад, обратно
dorf: деревня
links: налево (также nach), слева 
straße: улица
rechts: направо (также nach), справа
platz: место, площадь
norden: север
ort: место, небольшой городок
süden: юг
anfang: начало
westen: запад
mitte: середина
osten: восток
#Положение
ende: конец
hier: здесь, тут
da: там, тут, сейчас
oben: наверху
dort: там
unten: внизу
daneben: рядом
draußen: снаружи, на улице
hinten: сзади
#Состояния
hinter: позади чего-либо
wegsein: быть не здесь, отсутствовать, уйти (2 слова)
aufsein: быть открытым [об окне, двери, магазине] (2 слова)
zusein: быть закрытым (2 слова)
aussein: быть выключенным, не работать [о технике] (2 слова)
ansein:  быть включенным [о технике] (2 слова)
#Модальные и базовые глаголы
haben: иметь
müssen: быть должным, обязанным
sein: быть
sollen: быть должным, иметь приказ
werden: становиться
heißen: зваться, называться
können: мочь, уметь
brauchen: нуждаться в ч-л
wollen: хотеть
bekommen: получать
möchten: хотеть бы 
kriegen: получать, с трудом сдирать/стаскивать/удалять(например пятно) 
dürfen: мочь, иметь право, разрешение
#Глаголы движения, положения, состояния
gehören: принадлежать
schlafen: спать
laufen: бежать
stehen: стоять
fahren: ехать
aufstehen: вставать
fliegen: летать
liegen: лежать
kommen: приходить
sitzen: сидеть
tanzen: танцевать
gehen: идти
#Прилагательные-характеристики
spielen: играть
alt: старый
klein: маленький, низкий [о людях]
neu: новый, новенький
jung: молодой
schön: красивый
gut: хороший
kurz: короткий
schlecht: плохой
lang: длинный
normal: нормальный
#Предлоги, союзы и т. д.
hoch: высокий [о неодушевлённых предметах]
aber: но
vor: перед
oder: или
zwischen: между
und: и, а
ohne: без
aus: из
durch: через, сквозь
nach: после
auf: на
von: от
auch: также, тоже
bis: до
dann: тогда
für: за, для
denn: потому что
gegen: против
noch: ещё
#Другое
bei: при, у
sehr: очень
vielleicht: может быть
also: итак
möglich: возможно, реально, осуществимо
nur: только
lieber: лучше, охотнее
besser: лучше
nicht: не [частица отрицания]
weiter: дальше, продолжай
nichts: ничего, ничто
#Природа и погода
leider: к сожалению
wetter: погода
regen: дождь
grad: градус [температура, наклон]
klar: ясно [о погоде или «понятно»]
meer: море
sonne: солнце
feuer: огонь
scheinen: светить, сиять (о солнце), [по]казаться (в общем - оставлять впечатление), мерещиться
baum: дерево
wind: ветер
blume: цветок
#Люди
regnen: идти (о дожде)
kind: ребёнок
männlich: мужественный, мужской
junge: мальчик
frau: женщина, госпожа [вежливое обращение]
mädchen: девочка
dame: дама
jugendliche: молодой человек/девушка (не зависит от пола)
weiblich: женственный, женский
erwachsene: взрослый
mensch: человек
herr: мужчина, господин [вежливое обращение]
leute: люди
mann: мужчина
#Социальные контакты
international: интернациональный
gruß: приветствие
bitten: просить
sagen: сказать, говорить
danken: благодарить
sprechen: говорить, беседовать
sprecher: спикер, оратор
dank: благодарность
fragen: спрашивать
frage: вопрос
entschuldigung: извинение
antworten: отвечать
antwort: ответ
helfen: помогать
hilfe: помощь
#Телефонный разговор
erzählen: рассказывать
telefon: телефон
telefonieren: говорить по телефону
handy: мобильный телефон
wiederholen: повторять
anrufen: звонить кому-либо по телефону
anruf: телефонный звонок
buchstabieren: диктовать по буквам
#Чувства и эмоции
anrufbeantworter: автоответчик
hören: слышать
glauben: верить, считать [иметь мнение]
sehen: смотреть, видеть
lustig: весёлый
schmecken: чувствовать вкус, быть на вкус
zufrieden: довольный
riechen: чувствовать запах, пахнуть
ruhig: спокойный
böse: злой
lachen: смеяться
müde: усталый
gefallen: нравиться
glücklich: счастливый
mögen: испытывать симпатию, любить(нравиться) 
glück: счастье
#Семья и домашние животные
lieben: любить
heiraten: жениться, выходить замуж
tochter: дочь
kümmern: с sich - беспокоиться, печься, заботиться 
bruder: брат
familie: семья
schwester: сестра
ehefrau: жена
verwandte: родственник
ehemann: муж
geschwister: братья и сёстры
partner: партнёр
großeltern: бабушки и дедушки
mutter: мама
großmutter: бабушка
vater: отец
großvater: дедушка
eltern: родители
oma: бабушка [разговорное]
baby: младенец
opa: дедушка [разговорное]
sohn: сын
#Друзья и знакомые
hund: собака
fremd: чужой
beide: оба
kennen: знать, быть знакомым
kennenlernen: знакомиться
warten: ждать
bekannt: известный
besuchen: посещать [обычно человека]
besucher: посетитель
bekannte: знакомый
bleiben: оставаться
freund: друг
übernachten: переночевать
gleich: одинаковый, похожий, скоро
mitbringen: приносить с собой
allein: одинокий, один, в одиночку
mitkommen: прийти вместе с кем-либо
zusammen: вместе
#Праздники
mitmachen: делать что-то вместе с кем-то
party: вечеринка
mitnehmen: взять с собой
disco: дискотека
gratulieren: поздравлять
hochzeit: свадьба
glückwunsch: пожелание счастья, пожелание к празднику
einladung: приглашение
herzlich: сердечно, от всего сердца
einladen: приглашать
feiern: праздновать
gast: гость
grillen: жарить на гриле
#Приём пищи
geschenk: подарок
hunger: голод
trinken: пить
durst: жажда
bitter: горький
appetit: аппетит
frühstücken: завтракать
kochen: готовить, варить
frühstück: завтрак
essen: есть, кушать, еда
glas: стакан, стекло
#Рестораны и кафе
flasche: бутылка
bäckerei: пекарня
restaurant: ресторан
cafè: кафе
speisekarte: меню [в кафе, ресторане]
#Продукты питания
lokal: кафе, забегаловка
lebensmittel: продукты питания
butter: сливочное масло
fisch: рыба [как вид мяса только в единственном числе]
ei: яйцо
fleisch: мясо
brot: хлеб
hähnchen: курятина 
brötchen: булочка
schinken: ветчина
kuchen: пирог
öl: масло (растительное, моторное), нефть
pommesfrites: картошка фри (2 слова)
salz: соль
#Фрукты и овощи
reis: рис
obst: фрукты
gemüse: овощи
apfel: яблоко
kartoffel: картофель
banane: банан
salat: салат
birne: груша
#Напитки
tomate: помидор
getränk: напиток
saft: сок
schorle: напиток смесь ч-л с газировкой
tee: чай
wasser: вода
kaffee: кофе
bier: пиво
milch: молоко
#Аренда жилья
wein: вино
anzeige: aнонс, заявление/донос(в полицию), объявление(рекламное), показания(прибора), повестка
mieten: снимать (жильё), брать напрокат
wohnen: проживать (где-либо)
miete: арендная плата
wohnung: квартира
vermieten: сдавать жилье, давать напрокат
apartment: апартаменты
vermieter: арендодатель
haus: дом
#Дом, квартира, комнаты
eingang: вход
dusche: душ
ausgang: выход
balkon: балкон
halle: зал
küche: кухня
stock: этаж
toilette: туалет
aufzug: лифт
hell: светлый, светло
treppe: лестница
breit: широкий, широко
ecke: угол
kaputt: сломанный
raum: комната, помещение
reparieren: чинить
zimmer: комната [в квартире, отеле]
reparatur: починка, ремонт
farbe: краска, цвет
anschluss: подключение
#Мебель и интерьер
möbel: мебель
schlüssel: ключ
bett: кровать
schrank: шкаф
sofa: диван
kühlschrank: холодильник
tisch: стол
herd: кухонная плита
bild: картина
licht: свет
#Действие и взаимодействие
uhr: часы
machen: делать
öffnen: открывать
ausmachen: выключать, договариваться, выводить пятна, делать вывод/решать, улаживать, означать, равняться(об итоге)
schließen: закрывать
anmachen: включать
bringen: приносить, привозить, приводить, лишать, доводить
tun: поступать, делать
holen: приносить, доставать
suchen: искать
geben: давать
finden: находить
stellen: ставить
nehmen: брать
legen: класть
halten: держать
beginnen: начинать
benutzen: использовать, применять
#Хобби и привычки
aufhören: прекращать, заканчивать
hobby: хобби
kino: кинотеатр
freizeit: досуг, свободное время , рекреационный
lesen: читать
garten: сад
buch: книга
kulturell: культурный [связанный в культурой]
zeitung: газета
lied: песня
fernsehen: телевидение, смотреть телевизор
rauchen: курить
film: фильм
#Спорт
zigarette: сигарета
sport: спорт
schwimmen: плавать
verein: объединение, общество, клуб
schwimmbad: бассейн
schwimmhalle: бассейн
hallenbad: закрытый бассейн
fußball: футбол, футбольный мяч
gewinnen: выигрывать
#Покупки и одежда
bogen: дуга, лук [оружие]
laden: магазин
günstig: выгодный по цене, недорогой
geschäft: бизнес, магазин
billig: дешёвый, дешево
kiosk: киоск, ларек
teuer: дорогой
geöffnet: открыто, открытый
bestellen: заказывать
geschlossen: закрыто, закрытый
kasse: касса
anbieten: предлагать
angebot: предложение
bezahlen: оплачивать
prospekt: проспект [улица, рекламка]
tasche: сумка, карман
kaufen: покупать
empfehlen: рекомендовать
einkaufen: делать покупки
größe: размер
verkaufen: продавать
jacke: куртка
verkäufer: продавец
kleidung: одежда
schuh: ботинок
#Путешествия
preis: цена
heimat: родина
ausländer: иностранец
reisen: путешествовать
ausländisch: иностранный
reise: путешествие
hotel: отель
reisebüro: бюро путешествий
rezeption: рецепция
reiseführer: гид [человек, книга]
doppelzimmer: комната на двоих в отеле
koffer: чемодан
einzelzimmer: комната на одного в отеле
gepäck: багаж
halbpension: полупансион [в отеле, санатории]
abfahren: выезжать, отъезжать, отправляться
karte: карта, билет
abfahrt: отправление, отъезд
ausflug: экскурсия, поездка с целью развлечения
abfliegen: вылетать [например, на самолёте]
plan: план
abflug: вылет
eilig: спешный, спешно
ankommen: прибывать, приезжать
eile: спешка
ankunft: прибытие
sehenswürdigkeit: достопримечательность
ausland: заграница
#Транспорт и техника
besichtigen: посещать [место, достопримечательность]
auto: машина
fahrrad: велосипед
autobahn: скоростная трасса
radfahren: ехать на велосипеде
taxi: такси
lkw: грузовик
fahrer: водитель
fahrkarte: проездной билет
bus: автобус
ticket: билет [проездной, на мероприятие]
haltestelle: остановка общественного транспорта
einsteigen: входить, садиться [в транспорт]
bahn: полоса движения, трасса, [железная] дорога, дорожка (бег, плав), орбита/траектория, русло
aussteigen: выходить (из транспорта, игры)
frei: свободно, свободный
straßenbahn: трамвай
besetzt: занято
zug: поезд
langsam: медленный
bahnhof: вокзал
schnell: быстрый
bahnsteig: железнодорожная платформа
automat: автомат [устройство]
gleis: железнодорожный путь
automatisch: автоматически
flugzeug: самолёт
maschine: механизм, станок
flughafen: аэропорт
#Тело, уход за собой и медицина
kopf: голова
aussehen: выглядеть
hand: ладонь
bein: нога
baden: принимать ванну, купаться
fuß: ступня
bauch: живот
haar: волос
krank: больной (прилагательное)
mund: рот
auge: глаз
fieber: жар [температура]
blick: взгляд
arzt: врач
gewicht: вес
#Жизнь и смерть
doktor: доктор [врач, кандидат наук]
geboren: рожден(а)
gestorben: умер(ла)
leben: жить, жизнь
tot: мёртвый
#Учёба
kindergarten: детский сад
hausaufgabe: домашнее задание
laut: громкий, громко, согласно (чему-либо, напр. расписанию)
test: тест
leise: тихий, тихо
prüfung: экзамен
lernen: учить [что-нибудь], учиться
bleistift: карандаш
schule: школа
kugelschreiber: шариковая ручка
papier: бумага, документ
schüler: ученик
lehrer: учитель
studieren: учиться в вузе
leicht: лёгкий, легко
einfach: простой, просто
gruppe: группа
schwer: тяжёлый, тяжело
student: студент
lösung: решение, ответ [к задаче]
unterricht: занятие
fertig: готовый, готово
pause: пауза, перерыв
richtig: правильный, правильно
information: информация
falsch: неправильный, неправильно
beispiel: пример
fehler: ошибка
zumbeispiel: например (2 слова)
fehlen: отсутствовать
erklären: объяснять
praktikum: практика (после учёбы)
aufgabe: задание, задача, обязанность
#Языки
kurs: курс (дополнительное образование, направление движения, обменный)
buchstabe: буква
sprache: язык (немецкий, английский)
wort: слово
aussage: высказывание
satz: предложение(фраза), серия, ставка
bedeuten: означать, значить
#Работа и профессия
text: текст
beruf: профессия
chef: шеф
arbeiten: работать
kollege: коллега
arbeit: работа
kunde: клиент
job: работа [чаще ручной или несложный труд]
anrede: титул, обращение, официальная речь
arbeitslos: безработный
ansage: объявление, оповещение о чём-либо
durchsage: объявление [через громкоговоритель, аудио-систему]
selbstständig: самостоятельный, самозанятый
gespräch: разговор
problem: проблема
hausfrau: домохозяйка
wichtig: важный
hausmann: домохозяин
schluss: конец, завершение
arbeitsplatz: рабочее место
urlaub: отпуск
stelle: место, позиция, должность
verdienen: зарабатывать, заслуживать
#Компьютерная техника
führung: управление, руководство
#computer: компьютер
drucken: печатать
#internet: интернет
drücken: нажимать
#fax: факс
anklicken: кликнуть мышкой [на объект, ссылку]
drucker: принтер
#Государственные органы
#cd: компакт-диск
eintritt: вступление [в организацию, партию], вход [на мероприятие]
zoll: таможня
termin: запись на время [к врачу, чиновнику]
polizei: полиция
schalter: переключатель, окошко [в гос.органах, банке]
ausweis: документ, удостоверяющий личность [id-карта]
pünktlich: вовремя
pass: паспорт
nummer: номер [число]
gültig: действительный, актуальный
anmeldung: регистрация
ordnung: порядок
auskunft: выписка, справка
erlauben: разрешать
foto: фото
verboten: запрещено
#Анкеты и формуляры
beamter: госслужащий
formular: формуляр, бланк (для заполнения)
geburtsort: место рождения
ausfüllen: заполнять [документ, анкету]
alter: возраст
ankreuzen: отметить крестиком
familienstand: семейное положение
name: имя, название
ledig: холостой
vorname: имя
verheiratet: женат, замужем
familienname: фамилия
unterschreiben: подписывать
geburtsjahr: год рождения
unterschrift: подпись
#Финансы
geburtstag: день рождения
bank: скамья, банк
kreditkarte: кредитная карта
geld: деньги
rechnung: счёт [квитанция на оплату]
bar: наличные, бар
#Почта
überweisen: переводить [деньги, пациента от врача к врачу]
post: почта
postleitzahl: почтовый индекс
brief: письмо
abgeben: отдавать
briefmarke: почтовая марка
schicken: отправлять, посылать
absender: отправитель
abholen: забирать
empfänger: получатель, адресат
vorwahl: телефонный префикс (код горожа итд)
adresse: адрес
#В городе
hauptstadt: столица
park: парк
zentrum: центр
kirche: церковь
schloss: замок
rathaus: ратуша
messe: выставка-ярмарка
zoo: зоопарк
kaufhaus: торговый дом/центр
einkaufszentrum: торговый центр
markt: рынок
flohmarkt: блошиный рынок, барахолка
reihe: ряд
#Природа и погода
kette: цепь (в т.ч. ювелирная), сеть магазинов
nass: мокрый
trocken: сухой
heiß: жарко, горячий
warm: тепло, тёплый
kühl: прохладно, прохладный
kalt: холодно, холодный
dunkel: тёмный, темно
neblig: туманно
sonnig: солнечно
windig: ветрено
himmel: небо
gewitter: непогода
wolke: облако
bewölkt: облачно
schnee: снег
schneien: идти(о снеге)
natur: природа
landschaft: ландшафт
berg: гора
insel: остров
fluss: река
wald: лес
pflanze: растение
blatt: лист (дерева, травы, бумаги)
rose: роза
#Животные и птицы
ruhe: тишина, покой
tier: животное, зверь
vogel: птица
katze: кошка
pferd: лошадь
#Движение и транспорт
schwein: свинья, свинина
motor: мотор
wagen: автомобиль
motorroller: мотороллер, скутер
parken: парковаться
garage: гараж
unfall: несчастный случай
werkstatt: [авто]сервис
verkehr: транспорт
verkehrsmittel: транспортное средство
umsteigen: пересаживаться, переходить на другую ветку
verspätung: опоздание
stadtplan: план города
fahrplan: расписание движения
brücke: мост
#Направление и положение
ampel: светофор
dorther: оттуда
dorthin: туда
heraus: наружу
herein: внутрь
hinein: внутрь
einwärts: внутрь
vorbei: мимо
vorwärts: прямо, вперёд
vorne: впереди
außer: снаружи, кроме
außerhalb: за пределами
drinnen: внутри
drüben: с другой стороны, с той стороны
gegenüber: напротив
nächst: следующий
neben: рядом
überall: повсюду
weit: далеко
ziel: цель
#Раздел Weg- und zurück-
nähe: близость
wegbringen: унести
wegfahren: уехать
weggehen: уйти
weglaufen: убегать
wegnehmen: отнять, забрать
wegwerfen: выбросить
zurückfahren: ехать обратно
zurückgeben: отдать обратно
zurückgehen: идти обратно
zurückkommen: возвращаться
zurückkehren: возвращаться
#Время
zurücklaufen: бежать обратно
damals: тогда, в тот раз
erst: сначала, когда-то, только, первый
früh: рано
manchmal: иногда
übermorgen: послезавтра
vorgestern: позавчера
vorher: перед этим, до этого
wieder: снова
zuerst: сначала, для начала
#Путешествия
zuletzt: в завершение
tourist: турист
reservieren: резервировать
buchen: бронировать
packen: собирать чемоданы
einpacken: упаковывать
rucksack: рюкзак
weg: путь, дорога, прочь!
unterwegs: в пути, по дороге
flug: полёт
schiff: корабль
erreichen: достигать
verpassen: пропустить, упустить [транспорт, событие]
unterkunft: место для ночлега
auspacken: распаковывать (чемоданы)
strand: пляж
jugendherberge: хостел для молодёжи
verreisen: уезжать
rundgang: обход (врача, патруля) 
#Дом, квартира, комнаты
fundsache: найденная вещь, находка
umzug: переезд
einziehen: заезжать в квартиру/дом
stockwerk: этаж
geschoss: этаж
erdgeschoss: первый этаж
wohnzimmer: гостиная
schlafzimmer: спальня
keller: подвал
heizung: отопление
fenster: окно
lampe: лампа
stuhl: стул
tür: дверь
renovieren: делать ремонт
#Домашнее хозяйство
nachbar: сосед
haushalt: домашнее хозяйство
mittel: средство, средний
reinigung: уборка, чистка
putzen: чистить, мыть, убираться
aufräumen: убираться
seife: мыло
wäsche: бельё
handtuch: полотенце
schirm: ширма, заграждение
kalender: календарь
ding: вещь, предмет
#Кухня и приготовление пищи
sache: вещь, предмет
geschirr: посуда
löffel: ложка
messer: нож
gabel: вилка
tasse: чашка
teller: тарелка
topf: кастрюля, горшок
schere: ножницы
müll: мусор
schneiden: резать, стричь, с sich - порезаться
backen: печь, выпекать
#Приём пищи, еда, продукты питания
braten: жарить, жаркое
mittagessen: обед
rezept: рецепт
gericht: суд, блюдо
portion: порция
stück: штука
rest: остаток, сдача
probieren: пробовать [еду, напитки]
frisch: свежий
süß: сладкий
sauer: кислый, обиженный
scharf: острый, резкий, отчетливый
supermarkt: супермаркет
mineralwasser: минеральная вода
wurst: колбаса
käse: сыр
bohne: боб, леденец
orange: апельсин
zitrone: лимон
burger: гамбургер
hamburger: гамбургер
nudeln: лапша
# pizza: пицца
süßigkeit: сладость [например, конфеты]
zucker: сахар
eis: мороженое, лёд
schokolade: шоколад
torte: торт
#Глаголы движения, положения, состояния
suppe: суп
setzen: сажать, садиться(+sich)
fallen: падать
hängen: висеть, вешать
klappen: удаваться, склеиваться/срастаться, хлопать/стучать, идти на лад
passen: подходить
passieren: происходить
stattfinden: происходить, проходить, иметь место, состояться
beeilen: торопить
ausgehen: выходить в свет
#Действие и взаимодействие
bestehen: состоять (из), сдавать (экзамен)
lassen: оставлять, позволять
stören: мешать, беспокоить
abschließen: заканчивать/завершать, закрывать на ключ/запираться, подводить итог, изолировать
aufmachen: открывать
zumachen: закрывать
aufpassen: следить, присматривать
beenden: заканчивать
leihen: одалживать (и брать и давать)
nennen: называть
teilnehmen: принимать участие
unternehmen: предпринимать что-либо
untersuchen: исследовать, обследовать, расследовать
versuchen: пробовать, пытаться
wählen: выбирать
wecken: будить
wehtun: делать больно
weitermachen: продолжать
weiterhelfen: помочь еще в чем-либо
zeigen: показывать, указывать
austragen: разносить [письма, рекламки и т. д.]
bauen: строить
herstellen: производить
liefern: доставлять
organisieren: организовывать
#Одежда
schaffen: делать, создавать, справляться, успевать, суметь(сделать)
mode: мода 
tragen: носить [одежду] , нести [груз]
tshirt: футболка
bluse: блузка
hemd: рубашка
kleid: платье
pullover: свитер
hose: брюки
jeans: джинсы
rock: юбка
anzug: костюм (мужской, официальный)
mantel: пальто
stiefel: сапог
mütze: шапка
#Внешность и черты
ring: кольцо, круг, ринг
brille: очки
blond: светловолосый
dick: толстый
dünn: худой
fett: жирный, жир
fitsein: быть в форме (2 слова)
sportlich: спортивный
stark: сильный
hässlich: уродливый
sympathisch: симпатичный
arm: бедный, рука
reich: богатый
blöd: тупой
dumm: глупый
intelligent: интеллектуальный
klug: умный
faul: ленивый
fleißig: прилежный, старательный
freundlich: дружелюбный
froh: радостный
nett: милый
nervös: нервный
#Прилагательные-характеристики
traurig: грустный
sauber: чистый
schmutzig: грязный
hart: жесткий, твёрдый
weich: мягкий
leer: пустой
voll: полный
rund: круглый, приблизительный
bunt: цветной, пестрый
tief: глубокий
wach: бодрствующий, неспящий
offen: открытый
echt: настоящий, реальный
eng: узкий, тесный
ganz: целый
aktuell: актуальный
modern: современный
typisch: типичный
deutlich: чёткий, отчетливо, явственно 
direkt: прямой, прямолинейный
dringend: неотложный, срочный
gefährlich: опасный
schädlich: вредный
schlimm: плохой
schwierig: тяжёлый, трудный
streng: строгий
schwach: слабый
notwendig: необходимый
nützlich: полезный
praktisch: практичный
plötzlich: внезапный
privat: личный, приватный
total: полностью, на 100% 
unbedingt: безусловный
vorsichtig: осторожный
wahr: истинный, правдивый
#Чувства и эмоции
verschieden: разный, различный
erinnern: с sich - вспоминать 
ärgern: злить, с sich - злиться
denken: думать
hoffen: надеяться
weinen: плакать
träumen: мечтать, видеть сны
bequem: удобно, удобный
romantisch: романтично
aufregend: волнительно [позитивно]
spannend: увлекательно
langweilig: скучно
witzig: смешно, шутливо
fantastisch: фантастически
komisch: забавно, странно
furcht: страх, ужас
schreck: страх, ужас
furchtbar: ужасающе, пугающе
schrecklich: ужасно, страшно
stress: стресс
stressig: вызывающее стресс
ahnung: подозрение, предчуствие, понятие(о ч-л)
angst: страх
lieblings: любимый (предмет, человек и т.д.) префикс слова
#Социальные контакты
lust: желание, влечение, настроение, охота
person: персона
kontakt: контакт
rentner: пенсионер
besuch: визит, посещение
feier: праздник 
wunsch: пожелание
wünschen: хотеть, желать (также с sich)
schenken: дарить
dabeisein: быть, присутствовать при чём-либо (2 слова)
verabredetsein: договориться встретиться (2 слова)
paar: пара
ehepartner: супруг
verlieben: с sich - влюбляться 
chatten: чатиться
rufen: кричать, звать
ansehen: смотреть/осматривать, с sich - рассматривать
zuhören: внимательно слушать кого-либо
unterhalten: поддерживать(огонь, отношения), содержать(за свой счет), занимать, с sich - общаться/разговаривать
reden: разговаривать
diskutieren: дискутировать
mitspielen: подыгрывать, играть с кем-либо вместе
schimpfen: обзывать, ругать
streiten: спорить, ссориться, с sich - ругаться/воевать
lügen: лгать
#Хобби и досуг
lüge: ложь
interesse: интерес
interessieren: быть интересным, интересовать(к-л), с sich - интересоваться ч-л
interessant: интересно, интересный
spaß: удовольствие
musik: музыка
radio: радио
sendung: передача по тв, радио
singen: петь
gitarre: гитара
klavier: пианино
zeitschrift: журнал
rätsel: загадка
krimi: детектив [жанр]
comic: комикс
kamera: камера
fotoapparat: фотоаппарат
fotografieren: фотографировать
zeichnen: рисовать [карандашом], чертить
malen: рисовать красками
basteln: мастерить
sammeln: собирать, коллекционировать
spazierengehen: идти гулять
spaziergang: прогулка
zelt: палатка
spiel: игра
witz: шутка
#Культура
club: клуб
kultur: культура
kunst: искусство
veranstaltung: представление
ausstellung: выставка
festival: фестиваль
theater: театр
#Звёзды и фанаты
titel: название, заголовок
plakat: плакат
poster: постер
beliebt: пользующийся популярностью
berühmt: известный
fan: фанат
star: звезда(знаменитость), скворец
tour: тур [концертный]
#Здоровье и медицина
konzert: концерт
krankenhaus: больница
krankenkasse: больничная касса в германии
krankheit: болезнь
gesundheit: здоровье
gesund: здоровый
schwanger: беременная
erkältetsein: быть простуженным (2 слова)
husten: кашлять, кашель
grippe: грипп
schmerz: боль
sprechstunde: прием (врача, адвоката...), приемные часы
apotheke: аптека
medikament: медикамент
tablette: таблетка
ausruhen: отдыхать (также с sich)
#Тело и уход за собой
sterben: умирать
gesicht: лицо
ohr: ухо
zahn: зуб
hals: шея, горло
körper: тело
rücken: спина
magen: желудок
creme: крем
kosmetik: косметика
#Спорт
parfüm: парфюм
trainieren: тренироваться
training: тренировка
mannschaft: команда
sportplatz: спортплощадка
joggen: бегать трусцой
reiten: ездить верхом
ball: мяч
basketball: баскетбол
volleyball: волейбол
tennis: теннис
ski: лыжи
#Информация
planen: планировать
prüfen: проверять
rechnen: считать
austauschen: обмен/замена, менять/заменять/замещать, обмениваться(опытом, информацией), с sich - общаться
vergleichen: сравнивать
merken: замечать, понимать, с sich - запоминать
notieren: делать заметки, отмечать, помечать
teilen: делить, делиться
vergessen: забывать
informieren: информировать сообщать, с sich - осведомляться/получать информацию
berichten: докладывать
beantworten: отвечать
beschreiben: описывать
nachricht: сообщение, новость
artikel: артикль, статья (в газете/онлайн)
geschichte: история
notiz: заметка
#Мнение
zettel: записка, этикетка, листок, наклейкв
meinen: считать, иметь мнение
meinung: мнение
idee: идея
gegenteil: противоположность, антоним
unterschied: разница, отличие
begründen: обосновывать
dafürsein: быть «за» (2 слова)
dagegensein: быть «против» (2 слова)
einverstandensein: быть согласным (2 слова)
egal: всё равно, безразлично
#Учёба
wegen: блвгодаря, из-за, в связи с, в вид, в связи с, в виду
ausbildung: среднее-профессиональное образование
universität: университет
stipendium: стипендия
fach: учебный предмет/дисциплина, область, квалификация, выдвижной ящик/отделение/полка
tafel: школьная доска, плитка (шоколада)
heft: тетрадь
stift: карандаш
kenntnisse: знания
üben: делать упражнения
schriftlich: письменно
übersetzen: переводить
Übersetzung: перевод
aussprechen: произносить, говорить
quiz: опросник, квиз, викторина
note: оценка/балл, нота/тон, банкнота, нотка(запаха, вкуса)
bibliothek: библиотека
cafeteria: кафетерий
ferien: каникулы
#Работа
zeugnis: свидетельство, аттестат, диплом
kündigen: увольняться
freiwillig: добровольно
bewerben: рекламировать, подавать заявление/резюме, с sich - свататься
erfahrung: опыт
interview: собеседование, интервью
wettbewerb: конкурс, конкуренция
vertrag: договор
mitarbeiter: работник, сотрудник
babysitter: няня
baustelle: стройка
instrument: инструмент
büro: офис
team: команда
produkt: продукт
projekt: проект
qualität: качество
service: сервис
tipp: совет, намек, подсказка
#workshop: мастерская, воркшоп
feierabend: конец рабочего дня
#Финансы и почта
feiertag: выходной, праздник
kostenlos: бесплатно
preiswert: недорого
sparen: экономить
ausgeben: тратить
kredit: кредит
geldbörse: кошелёк
ermäßigung: скидка
paket: посылка
#Государственные органы
postkarte: открытка
situation: ситуация
bedanken: с sich - благодарить 
beschweren:обременять/отягощать, с sich - жаловаться
beraten: консультировать
raten: советовать, угадывать
vereinbaren: согласовать [время], договориться
verschieben: передвинуть
ändern: изменить
bestätigen: подтвердить
wechseln: [за]менять
kontrollieren: контролировать
eintragen: записать, внести
#Компьютер и техника
verbieten: запрешать
apparat: аппарат
gerät: прибор, инструмент
fernseher: телевизор
#laptop: ноутбук
#tablet: планшет
mobiltelefon: мобильный телефон
#ebook: электронная книга
#blog: блог
#website: сайт в интернете
webseite: страница в интернете
#homepage: домашняя страница
#programm: программа
#mailbox: электронный почтовый ящик
#email: электронная почта, письмо
passwort: пароль
kennwort: пароль
#link: ссылка
datei: файл
#online: онлайн
surfen: серфить (в море, в интернете)
herunterladen: скачивать
#Количество
speichern: сохранять
menge: количество
zahl: число, количество, цифра, численность
wenige: некоторые, мало кто/что
wenigstens: как минимум, по крайней мере
meistens: в большинстве случаев, в основном
#Местоимения
mindestens: минимум, по меньшей мере
selbst: самостоятельно
jemand: кто-то
man: некто [неопределённо-личное местоимение]
niemand: никто
welche: которые, некоторые
etwas: что-либо, сколько-нибудь, немного, несколько, чуть, слегка
#Наречия
kein: никто, ничто [отрицательное местоимение]
gern: охотно, с удовольствием
genau: точно
sicher: уверенный, безопасный/надежный, точно/конечно! 
natürlich: естественно! конечно!
wahrscheinlich: возможно
hoffentlich: надеюсь
wirklich: действительно
toll: классный, класс!
schade: жаль
fast: почти
endlich: наконец-то!
genug: достаточно
eigentlich: в действительности
sogar: даже
sonst: другой, в противном случае 
außerdem: кроме того
deshalb: поэтому
doch: всё же, всё-таки
anders: иначе, по-другому
#Омонимы
besonders: особенно, в частности, в особенности 
band: музыкальная группа, лента, том (книга)
gehalt: зарплата, содержимое
see: море, озеро
#Союзы
dass: что, чтобы
weil: потому что
wenn: если
#Устойчивые выражения
als: когда, как, чем (при сравнении)
#auf jeden fall: в любом случае (3 слова)
#auf keinen fall: ни в коем случае (3 слова)
bescheid: информация, ответ, сообщение, справка, уведомление
bescheidbekommen: узнать о решении (2 слова)
bescheidgeben: дать знать о чём-либо (2 слова)
bescheidsagen: дать знать о чём-либо (2 слова)
rechthaben: быть правым (2 слова)
vorschlag: предложение
einenvorschlaghaben: иметь предложение
einenvorschlagmachen: сделать предложение [не руки и сердца]
ab: с, от, начиная с
an: у, к, на
in: в
ja: да
ne: нет
so: так, итак
um: вокруг, у
zu: к, слишком
eh: прежде, раньше, вот как?!
ex:бывший
#Восклицания
gleichfalls: Взаимно!
klasse: класс, Класс!
prima: Круто!
prost: Восклицание-тост
super: Супер!
verzeihung: Простите!
#Общество
wunderbar: чудесный, чудный, Чудесно!
bevölkerung: население
bürger: горожанин, гражданин
bewohner: житель
einwohner: житель
öffentlichkeit: общественность, публичность
öffentlich: публичный, общественный
gemeinschaft: сообщество
gesellschaft: товарищество, [co]общество, компания(также коммерческая)
#gesellschafter: акционер, компаньон, участник, собеседник 
#gesellschaftlich: общественный, коллективный
freundschaft: дружба
menschlich: человеческий
typ: тип, парень (разг.)
jugend: молодёжь
#Брак
bub: мальчишка, шкет
ehe: брак
ehepaar: супружеская пара
#sich scheiden lassen: разводиться
geschieden: разведён, разведенный (о супругах)
scheidung: развод
getrenntleben: жить отдельно, быть больше не вместе (2 слова)
trennen: разделять,разлучать,отделять(белки от желтков),размыкать(цепь), с sich - разлучаться
#Семья
trennung: расставание, разлука
heim: (отчий)дом, жилище, приют, домой/на родину (возвращаться)
heimlich: тайно
verwandt: родственный, похожий, близкий
generation: поколение
angehörige: родственник
nachwuchs: потомство
enkel: внук
onkel: дядя
tante: тётя
neffe: племянник
nichte: племянница
cousine: кузина
cousin: кузен
#Социальные контакты
haustier: домашнее животное
selber: самостоятельно
gemeinsam: вместе
miteinander: друг с другом
beziehung: отношение, отношения
verabreden: договариваться, уславливаться (таже с sich)
verabredung: договорённость (о встрече), встреча
treffpunkt: пункт встречи
treffen: встреча, матч, попадание(в цель), сходка/слет.сбор; попадать, нарываться/повстречать, с sich - встречаться
empfang: приём, приёмная
empfangen: принимать, встречать
lächeln: улыбаться
grüßen: приветствовать
küssen: целовать
kuss: поцелуй
umarmen: обнимать
eindruck: впечатление
kommunikation: коммуникация
dialog: диалог
duzen: говорить «на ты»
siezen: говорить «на вы»
diskussion: дискуссия
widersprechen: возражать
wetten: спорить [на что-то]
weigern: с sich - отказаться, уклониться 
kritik: критика
kritisieren: критиковать
kritisch: критический
peinlich: стыдный
reaktion: реакция
#sich etwas gefallen lassen: принять что-либо, даже если это очень неприятно, проглотить услышанное
konflikt: конфликт
streit: ссора
rücksicht: оглядка, деликатность, внимание к кому-либо/чему-либо, уважение
respekt: уважение в общем смысле [например, к старшим]
kompromiss: компромисс
einigen: объединять, с sich - договариваться/сходиться
entgegenkommen: пойти навстречу
einverstanden: согласен, согласный
verzeihen: прощать, извинять
loben: хвалить
ratschlag: совет, рекомендация
verabschieden: принимать/утверждать(закон), с sich - прощаться
abschied: прощание
#Чувства и эмоции
gratulation: поздравление
spüren: чуять
fühlen: чувствовать, ощущать
gefühl: чувство, ощущение
gucken: глядеть
schauen: смотреть
zuschauen: наблюдать, наблюдать, смотреть как кто-то что-то делает, что-то происходит
blind: слепой
ärgerlich: неприятный, обидный, раздражающий
ärger: злость, проблемы (с кем-либо)
wütend: яростный, в ярости
gewöhnen: приучать, с sich - привыкать,приучаться
gewöhnlich: привычно, обычно, обычный
gewohnt: привыкший
gewohnheit: привычка
langweilen: наводить скуку, с sich - скучать
langeweile: скука
fürchten: бояться, опасаться чего-либо (также с sich)
wundern: удивлять, с sich - удивляться
irren: блуждать, с sich - ошибаться 
gedanke: мысль
nachdenken: обдумывать
zweifeln: сомневаться
zweifel: сомнение
sorge: забота
verständnis: понимание
verständlich: понятный, ясный, доступный для понимания
gewissen: совесть
humor: юмор
mut: смелость, отвага
mutig: смелый, отважный
freude: радость
geduld: терпение
absicht: намерение
fantasie: фантазия
liebe: любовь
mühe: старание, усилия, хлопоты, труд
pech: неудача
hoffnung: надежда
laune: настроение
stimmung: настроение, дух, муз. строй, настрой
träne: слеза
schreien: кричать
schweigen: молчать, молчание
brennen: гореть
frieren: мёрзнуть
einsam: одинокий
leiden: страдать
stolz: гордый
stumm: немой (прил)
stumme: немой, немая (сущ)
taub: глухой
traum: мечта, сон, идеальный, моей мечты [приставка]
verrückt: безумный 
wahnsinnig: безумный 
wohl: хорошо [например, себя чувствовать], приятно, вероятно (должно быть)
#В городе и деревне
hassen: ненавидеть
städtisch: городской
metropole: метрополия
viertel: квартал, район, четверть
zentral: центральный
lärm: шум
zone: зона [например, пешеходная]
ländlich: деревенский, сельский
rand: край, окраина
vorort: пригород 
hof: двор
bau: стройка
gebäude: здание, постройка
turm: башня
burg: крепость
hütte: хижина
bauernhof: ферма, крестьянское хозяйство
feuerwehr: пожарная охрана
fundbüro: бюро находок
#Почта
lager: склад, лагерь
bankleitzahl: банковский код, бик
einschreiben: заказное письмо
briefumschlag: конверт
briefkasten: почтовый ящик
briefträger: почтальон
#Дом, квартира, комнаты
senden: отправлять
grundstück: земельный участок
tor: ворота
terrasse: терраса
mauer: стена [внешняя]
wand: стена [внутренняя]
dach: крыша
decke: одеяло, потолок
etage: этаж
treppenhaus: лестничная площадка
leiter: лестница (приставная), руководитель
stufe: ступень
lift: лифт
zuhause: дома
flur: коридор
gang: проход, коридор, походка, передача в машине
korridor: коридор
saal: зал
bad: ванная комната, ванна
badewanne: ванна
leitung: cуффикс "-провод" (трубопровод и т.п.), дирекция, руководство
garderobe: гардероб
klimaanlage: кондиционер
anlage: установка, устройство, система для чего-либо
alarm: сигнал тревоги
klingeln: звонить в звонок
klingen: звенеть, звучать
#Мебель и интерьер
klingel: дверной звонок
möbliert: меблированный
sessel: кресло
couch: диван
regal: полка
kissen: подушка
backofen: духовка
dekorieren: декорировать, украшать
spiegel: зеркало
teppich: ковёр
wecker: будильник
kanne: кувшин, чайник
kerze: свеча
vase: ваза
fotografie: фотография
puppe: кукла
individuell: индивидуальный
angenehm: приятный
gemütlich: уютный
farbig: цветной
üblich: обычный
niedrig: низкий [например, о высоте]
riesig: огромный
schief: кривой, косой, перекошенный
sichtbar: видимый
speziell: специальный
#Материалы
spitz: острый, заостренный, колкий(также в пер. смысле), остроконечный
material: материал
stoff: материал, материя (также в физ. и филос.)
holz: дерево [материал]
metall: металл
plastik: пластик
kunststoff: пластик
gold: золото
leder: кожа [животного]
pflaster: пластырь, брусчатка
#Домашнее хозяйство
wolle: шерсть
mieter: арендатор
raucher: курящий человек
nichtraucher: некурящий человек
gegenstand: предмет, объект
feuerzeug: зажигалка
streichholz: спичка
zündholz: спичка
schaden: вредить, вред, повреждения, убыток
fleck: пятно
schmutz: грязь
dreck: грязь
staub: пыль
stinken: вонять, неприятно пахнуть
waschmittel: средство для стирки 
reinigen: чистить, мыть
spülen: споласкивать, мыть посуду
staubsaugen: пылесосить
gründlich: основательно
ordentlich: аккуратный, порядочный, приличный, в порядке, очередной, очень, немалый, действительный(член)
abfall: отходы
abfalleimer: мусорное ведро
mülltonne: контейнер для мусора [на улице]
müllabfuhr: вывоз мусора
anbieter: провайдер, поставщик услуг
strom: поток, электричество
gas: газ
heizen: отапливать
trocknen: сушить
hammer: молоток
handwerker: ремесленник
hausmeister: дворник, завхоз
kasten: ящик
kiste: ящик
tüte: пакет
sack: мешок
bürste: щётка
nadel:стрелка(компаса), игла, булавка, спица
#Приём пищи
schüssel: миска
imbiss: закусочная, мини-кафе [часто на колёсах]
kantine: столовая
kneipe: небольшое кафе, пивнушка
durstig: жаждущий, испытывающий жажду
hungrig: голодный
satt: сытый, сочный (о цвете)
fressen: есть [о животных]
zubereiten: готовить [в т.ч. еду], подготавливать
menü: меню [готовый набор блюд в кафе]
mahlzeit: приём пищи, приятного аппетита!
nachspeise: десерт
dessert: десерт
speisewagen: вагон-ресторан
büchse: жестянка, консервная банка
dose: консервная банка, розетк
pfanne: сковорода
nahrungsmittel: продукт питания
#Продукты питания
geschmack: вкус
gift: яд
giftig: ядовитый
lecker: вкусно
salzig: солёный
roh: сырой (оо продуктах продуктах)
mild: не острый, «мягкий» на вкус
mager: нежирный, постный, тощий
haltbar: длительного хранения, прочный, ноский, добротный 
vegetarisch: вегетарианский
zutat: ингредиент, добавка, компонент, приправа 
rind: говядина, корова, бык
hackfleisch: фарш
karotte: морковь
möhre: морковь
zwiebel: лук
frucht: фрукт, плод
aprikose: абрикос
pflaume: слива
konfitüre: конфитюр, варенье
marmelade: джем, варенье
limonade: лимонад
pilz: гриб
mehl: мука
essig: уксус
honig: мёд
kakao: какао
pfeffer: перец [горошком, молотый]
gewürz: приправа
schlagsahne: сливки для взбивания, взбитые сливки
margarine: маргарин
alkohol: алкоголь
gebäck: выпечка
müsli: мюсли
schnitzel: шницель
kloß: шарик из картофеля или хлеба [блюдо]
knödel: шарик из картофеля или хлеба [блюдо]
nudel: лапша
#Движение
soße: соус
start: старт
schritt: шаг
richtung: направление
bewegung: движение
mobil: мобильный
springen: прыгать
treten: наступать
stürzen: кинуться, свергать
steigen: подниматься, расти (о показателях), расти, подниматься, увеличиваться
fließen: течь
landen: приземляться
eilen: торопиться, поторапливаться
#Направление и положение
folgen: следовать
befinden: самочуствие, с sich - оказываться, находиться
lage: положение, состояние
außen: снаружи, вовне
äußerlich: внешне, поверхностный, наружный(о лекарстве), извне, показной
raus: наружу
rein: внутрь, чистый
innen: внутри
drin: внутри
inner: внутренний
abwärts: вниз, под уклон
sinken: тонуть, идти ко дну
aufwärts: наверх, в гору, наверх, в гору
rauf: наверх
steil: крутой, отвесный
entlang: вдоль
parallel: параллельный
ober: верхний
mitten: в середине
letzt: последний
senkrecht: по вертикали
waagerecht: горизонтальный, по горизонтали
nah: близко
nebenan: по соседству, поблизости
nirgendwo: нигде
folgend: следующий, дальнейший, очередной
reihenfolge: очерёдность
#Действие и взаимодействие
achten: обращать внимание, следить
beißen: кусать, жалить (о змее), жечь, щипать(язык, глаза)
bewegen: шевелить, передвигать, колебать, побуждать (сделать ч-л)
brechen: ломать
drehen: крутить, вращать, снимать фильм
fangen: ловить
fassen: хватать, улавливать, понимать
führen: вести
füttern: кормить [животное]
gebrauchen: использовать, приспосабливать, употреблять, приспосабливать, употреблять
gelten: быть действительным, актуальным
genügen: быть достаточным
greifen: хватать 
heben: поднимать (в т.ч. бокал)
hinterlassen: оставлять после себя (наследство, мусор...)
kleben: клеить, наклеивать
klopfen: стучать ладонью, выбивать (ковёр)
leidtun: вызывать сожаление/сочувствие/жалость (мне жаль) 
markieren: маркировать
mischen: смешивать, перемешивать
nutzen: пользоваться, воспользоваться, приносить пользу 
nützen: быть полезным
reagieren: реагировать
reichen: хватать(быть достаточным), доставать, дотягиваться (до чего-либо), (передавать за столом соль и тд)
retten: спасать
schätzen: оценивать
schieben: толкать
schießen: стрелять
schlagen: бить
schütteln: трясти, шатать, качкак действиеать (головой)
sichern: защищать, как действиеобезопасить
sorgen: заботиться
stechen: колоть, жалить 
stecken: вставлять [например вилку в розетку]
treiben: гнать/погонять (кого-то/что-то), заниматься(спортом), нести что-либо (о ветре, течении), приводить в движение
verwechseln: перепутать
verzichten: отказываться (от сахара или алкоголя)
warnen: предупреждать
werfen: бросать
winken: махать рукой, привлекать внимание
wirken: оказывать воздействие, производить впечатление (казаться), работать (срабатывать), ткать
werk: дело, предприятие(завод), произведение(книга, картина), механизм
wirkung: воздействие
zerstören: разрушать
ziehen: тянуть (настаиваться - о чае)
zurechtkommen: разобраться [например, найти самому что нужно в магазине]
verbessern: исправлять, улучшать, налаживать, с sich - улучшаться
#Транспорт
zwingen: вынуждать, принуждать
mobilität: мобильность, транспорт
transport: транспорт
transportieren: транспортировать
strecke: расстояние, маршрут
station: станция
halt: остановка, стоянка, привал, опора, стой!
kabine: кабина
#Вождение
sitz: место [для сидения], кресло в машине/транспорте
kraftfahrzeug: автомобиль, машина
fahrzeug: транспортное средство
rad: колесо, велосипед
motorrad: мотоцикл
reifen: шина, резина для колеса
laster: грузовик
kennzeichen: номерной знак
führerschein: водительское удостоверение
tanken: заправляться
tankstelle: заправочная станция
diesel: дизель
benzin: бензин
losfahren: отправляться в путь
starten: стартовать
rückwärts: задом, задним ходом
rennen: бежать, мчаться
wenden: разворачиваться
bremsen: тормозить
abbiegen: поворачивать, сворачивать (влево, вправо)
stehenbleiben: остановиться, остаться стоять
bremse: тормоз
stoppen: останавливать
nähern: с sich - приближаться, сближаться 
hupen: сигналить
stoßen: толкать, упираться, ударять(по мячу), с sich - сталкиваться, ударяться 
geschwindigkeit: скорость
tempo: темп, скорость
zeichen: знак
geschwindigkeitsbeschränkung: ограничение скорости
verkehrszeichen: дорожный знак
schild: знак [дорожный], щит, вывеска, табличка
passagier: пассажир
verkehrsschild: дорожный знак
radfahrer: велосипедист
fußgänger: пешеход
gehsteig: тротуар, дорожка для пешеходов
fußgängerzone: пешеходная зона
einbahnstraße: улица с односторонним движением
fahrbahn: дорога для автомобилей
einfahrt: въезд для транспорта (в гараж, во двор, на стоянку)
kurve: кривая, изгиб дороги
auffahrt: съезд (на автобан)
ausfahrt: съезд (с автобана)
distanz: дистанция
stau: пробка (на дороге)
#Путешествия
panne: авария/поломка, неудача
konsulat: консульство
tourismus: туризм
tram: трамвай
Straßenbahn: трамвай
visum: виза
boot: лодка
hauptbahnhof: центральный вокзал
eisenbahn: железная дорога
fähre: паром
hafen: гавань
gaststätte: гостевой дом, небольшой отель
gasthaus: гостевой дом, небольшой отель
buffet: буфет
reservierung: резервирование(существительное), бронь 
denkmal: памятник
rundfahrt: экскурсия [обычно на автобусе и круговая]
souvenir: сувенир
abenteuer: приключение
weltweit: по всему миру
wanderung: путешествие пешком, поход
landung: приземление
zelten: разбивать палатки, жить в палатках на природе
rückkehr: возвращение
#Окружающая среда
rückfahrt: обратная дорога
erde: земля, почва
mond: луна
stern: звезда
bio: био [приставка]
biologisch: биологический
biologie: биология
öko: эко [приставка]
ökologisch: экологичный
umwelt: окружающая среда
verschmutzen: загрязнять
umweltverschmutzung: загрязнение окружающей среды
beschützen: защищать
schützen: защищать
umweltschutz: защита окружающей среды
kraftwerk: электростанция
katastrophe: катастрофа
saison: сезон
klima: климат
gegend: местность, окресности, район
region: регион
regional: региональный
luft: воздух
abgase: выхлопные газы
ozean: океан
ufer: берег
küste: побережье, пляж
sand: песок
feld: поле
wiese: луг
tal: долина
gras: трава
rasen: газон, газонная трава
blühen: цвести
gebirge: горы
hügel: холм
boden: пол, почва, земля
stein: камень
schlange: змея
#Природа и погода
ernte: урожай
wetterbericht: прогноз погоды
wettervorhersage: прогноз погоды
temperatur: температура
hitze: жара
wärme: тепло
kälte: мороз, холод
schatten: тень
feucht: влажный, промозглый, сырой
tropfen: капля
sturm: шторм, штурм
blitzen: сверкать [как молния]
blitz: молния
donnern: греметь [как гром]
donner: гром
hageln: сыпать градом
hagel: град
#Иммиграция
nebel: туман
stammen: происходить (откуда-то)
herkunft: происхождение
ursprünglich: исходный
national: национальный
migrant: мигрант
migration: миграция
aufenthalt: пребывание/проживание, остановка(в пути), стоянка(поезда)
asyl: убежище [программа для иностранцев]
integration: интеграция
#Государственные органы
heimweh: тоска по родине
amt: государственное учреждение, важный пост [должность]
behörde: государственный орган, ведомство
institut: институт [организация]
botschaft: посольство
terminkalender: ежедневник, органайзер
stempel: штемпель
urkunde: свидетельство
mappe: папка для документов
dokument: документ
kopie: копия
daten: данные [например, личные]
personalien: личные данные [ФИО, номер телефона и т. д.]
geschlecht: пол [человека]
wohnort: город проживания
wohnsitz: место жительства [полный адрес]
rufnummer: телефонный номер
anspruch: право на что-либо [например, на пособие]
antrag: заявление, запрос
bedingung: условие
bestätigung: подтверждение
pflicht: обязанность
erlaubnis: разрешение 
arbeitserlaubnis: разрешение на работу
genehmigung: разрешение, одобрение, санкция 
genehmigen: одобрить, разрешить, санкционировать, удовлетворить
forderung: требование
fordern: требовать, выдвигать требования
förderung: содействие, финансовая поддержка
fördern: способствовать, содействовать, оказывать финансовую поддержку
frist: срок, отсрочка 
mahnung: требование [обычно об оплате просрочки]
meldung: заявление, объявление
melden: заявлять
mitteilung: сообщение, уведомление
mitteilen: сообщать, уведомлять
persönlich: личный
geehrt: поитаемый, почтенный, уважаемый
#Закон и порядок
trotz: вопреки
gesetz: закон
gesetzlich: законный
gewalt: власть, насилие
recht: право, правый
rechtlich: правовой
gerecht: честный, справедливый 
gleichberechtigt: равноправный
richter: судья
illegal: нелегальный, противозаконный
kriminal: криминальный [приставка]
kriminalpolizei: криминальная полиция
klagen: подавать в суд
tat: поступок, акт, действие, дело
urteil: приговор
verurteilen: выносить приговор, осуждать, судить
polizist: полицейский
uniform: униформа
grenze: граница
täter: преступник, виновник
verdacht: подозрение
verdächtig: подозрительный
dieb: вор
stehlen: красть
verbrecher: нарушитель, преступник
einbrechen: вламываться [с целью ограбить]
einbrecher: взломщик
einbruch: взлом, вторжение
protest: протест
protestieren: протестовать
flucht: побег
fliehen: сбегать, убегать, спасаться бегством
verhaften: арестовывать, задерживать [за преступление]
verwaltung: управляющая компания
sicherheit: безопасность
spur: след
opfer: жертва
zeuge: свидетель, очевидец, современник, понятой
schutz: защита
verbot: запрет
strafzettel: штрафная квитанция 
strafe: наказание
strafbar: наказуемо
gefängnis: тюрьма
schuld: вина, виноватый
schulden: долги
schuldig: виноватый, должный
regel: правило
folge: последствие, серия (сериала)
tatsache: факт
tatsächlich: фактически, в действительности
offiziell: официальный
merkwürdig: подозрительный
geheimnis: тайна
#Война и мир
geheim: тайный
krieg: война
frieden: мир [не вражда]
kampf: борьба
#Политика
freiheit: свобода
kämpfen: бороться
politisch: политический
politik: политика
rede: речь
kandidat: кандидат
stimmen: голосовать, согласовывать, настраивать(инструмент), быть верным
wahl: выбор
reform: реформа
politiker: политик
besserung: улучшение
Änderung: изменение
endgültig: окончательный
streik: забастовка
realisieren: реализовывать
#Жизнь, смерть, религия
regeln: улаживать что-либо, регулировать(упорядочивать), регламентировать
alltag: быт, повседневность
alltäglich: бытовой, повседневный
täglich: ежедневно
tagesablauf: распорядок дня, режим дня
#geboren werden: рождаться
kindheit: детство
wachsen: расти, взрослеть
verändern: изменять(ч-л), с sich - изменяться
veränderung: изменение
rente: пенсия
inrentegehensein: выходить на пенсию (4 слова)
#pensioniert werden sein: выходить на пенсию [часто для военных] (3 слова)
pensioniert: вышедший на пенсию
senioren: пожилые люди [социальная группа]
altenheim: дом престарелых
altersheim: дом престарелых
tod: смерть
tote: умерший
tödlich: смертельный
wunder: чудо
gott: бог
#Тело и органы
religion: религия
atmen: дышать
atem: дыхание
bluten: кровоточить
blut: кровь
muskel: мускул
knochen: кость
nerv: нерв
haut: кожа [человеческая]
lippe: губа
nase: нос
herz: сердце
finger: палец
nagel: гвоздь, ноготь
schulter: плечо
brust: грудь
knie: колено
körperlich: телесный, физический
wiegen: весить, взвешивать
#Медицина
stimme: голос
medizin: медицина, лекарство
praxis: клиника, (частная) практика(врач), практика(а не теория)
klinik: клиника
patient: пациент
kranke: больной (существительное)
krankenwagen: машина скорой помощи
pflegen: ухаживать
pfleger: сиделка [мужчина], санитар
krankenpfleger: санитар, сиделка [мужчина]
krankenschwester: медсестра
krankenversicherungskarte: карта медицинского страхования
versichertenkarte: карта застрахованного
infektion: инфекция
spritze: шприц, инъекция
operation: операция
operieren: оперировать
therapie: терапия
pille: таблетка [часто противозачаточные]
salbe: мазь
vitamin: витамин
schmerzmittel: обезболивающее
fiebermittel: жаропонижающее
droge: наркотик
suchtmittel: вещество, вызывающее зависимость
sucht: зависимость
süchtig: зависимый
schwangerschaft: беременность
geburt: роды, рождение
wunde: рана
schnupfen: насморк
schlaf: сон
virus: вирус
diät: диета
zahnpasta: зубная паста
#Внешность и характер
zahnbürste: зубная щётка
ähnlich: похожий
besonder: особенный
bart: борода
blass: бледный
bleich: бледный, обесцвеченый
schlank: худой, стройный
schmal: узкий, тонкий
kräftig: сильный, крепкий [например, о кофе]
hübsch: симпатичный, милый, красивый
elegant: элегантный
schick: шикарный
ideal: идеальный
perfekt: идеальный
wunderschön: великолепно, очень красиво
seltsam: странный
ängstlich: пугливый
ehrlich: честный
frech: наглый
neugierig: любопытный
optimistisch: оптимистичный
pessimistisch: пессимисичный
positiv: позитивный, положительный 
negativ: негативный, отрицательный 
still: тихий, без газа [о воде]
wild: дикий
passiv: пассивный
aktiv: активный
reif: спелый, зрелый [в т.ч. о людях]
ernst: серьёзный
vernünftig: разумный, здравомыслящий, рассудительный
erfolgreich: успешный, удачный
bereit: готовый
gespannt: напряжённый, натянутый (об отношениях), пристальный (о внимании)
entspannt: расслабленный
kreativ: креативный
sozial: социальный
asozial: асоциальный
treu: верный
tolerant: толерантный
intolerant: нетолерантный
fröhlich: радостный
höflich: вежливый
aufmerksam: внимательный
dankbar: благодарный
#Красота и одежда
lieb: любимый, родной
salon: салон [например, красоты]
friseur: парикмахер
frisur: причёска
rasieren: брить
schminken: делать макияж (кому-либо)
tuch: платок
taschentuch: носовой платок
hut: шляпа
strumpf: чулок
socke: носок
#Хобби и досуг
schmuck: украшение [ювелирное, для дома и т. п.]
amüsieren: развлекать 
vergnügen: развлечение, удовольствие, с sich - забавляться/развлекаться 
aktivität: активность
faulenzen: лентяйничать
genießen: наслаждаться
interessiert: заинтересованный
fasching: фашинг, немецкий национальный карнавал
karneval: карнавал
kostüm: национальный/карнавальный костюм, женский деловой костюм
tierpark: зоопарк
buchhandlung: книжный магазин
magazin: журнал
märchen: сказка
broschüre: брошюра
leser: читатель
abonnieren: подписываться, делать абонемент
abonnement: абонемент
mitglied: член [общества, команды]
#imfreien: под открытым небом, на свежем воздухе
golfspiel: игра в гольф
picknick: пикник
grill: гриль
disko: диско
diskothek: дискотека
zirkus: цирк
spielplatz: игровая площадка
spielzeug: игрушка
werkzeug: инструмент
zange: клещи, щипцы
nähen: шить
pflanzen: сажать, выращивать растения
gießen: поливать
tauchen: нырять
#Спорт
klettern: лезть,карабкаться (на гору, дерево)
sportart: вид спорта
gymnastik: гимнастика
sportler: спортсмен
spieler: игрок
trainer: тренер
stadion: стадион
rekord: рекорд
schwitzen: потеть
siegen: побеждать
sieg: победа
sieger: победитель
verlieren: терять, проигрывать
verlierer: проигравший, неудачник
#Культура
gegner: противник
musikalisch: музыкальный
musiker: музыкант
orchester: оркестр
sänger: певец
flöte: флейта
oper: опера
original: оригинал, оригинальный, истинный, не копия
publikum: публика
talent: талант
galerie: галерея
schauspieler: актёр
rolle: роль
serie: сериал
szene: сцена [в кино]
bühne: сцена [для выступления]
literatur: литература
schriftsteller: писатель
autor: автор
held: герой [в т.ч. в книге и т. п.]
figur: фигура, персонаж
roman: роман
gedicht: стихотворение, поэма
verlag: издательство
veröffentlichen: публиковать
fortsetzung: продолжение
fortsetzen: продолжать
stil: стиль
tanz: танец
ballett: балет
museum: музей
annonce: анонс
tradition: традиция
#interkulturell: межкультурный
künstlich: искусственный, ненастоящий
populär: популярный
stilistisch: стилистический
#События
traditionell: традиционный
neuigkeit: новинка, новость
gelegenheit: возможность, момент что-то сделать
möglichkeit: возможность
chance: шанс
ereignis: событие
ereignen: с sich - случаться, происходить
geschehen: случаться, происходить
gelingen: удаваться
#СМИ
fall: случай
medien: средства массовой информации [сми] (Pl.)
presse: пресса, пресс [машина]
reporter: репортёр
reportage: репортаж
reklame: реклама 
werbung: реклама
#Покупки
sender: отправитель, радиостанция, телеканал
drogerie: магазин косметики, парфюмерии и средств для дома
einkauf: покупка
konsumieren: потреблять, употреблять (алкогоголяль)
konsum: потребление, употребление(алкоголголяя)
empfehlung: рекомендация
ware: товар
katalog: каталог
schaufenster: витрина
lieferung: доставка
schachtel: коробочка, картонная упаковка [от сигарет]
kauf: покупка
garantie: гарантия
garantieren: гарантировать
sparsam: экономный
wert: ценность, стоимость, ценный [приставка]
wertlos: не имеющий ценности, бессмысленный, бесполезный
wertvoll: ценный
sonderangebot: распродажа по сниженным ценам
rabatt: скидка
aktion: акция
gratis: бесплатно, в подарок [обычно когда акция в магазине]
inklusive: включительно
einschließlich: включительно
komplett: полностью, полный
lohnen: окупать/оправдывать(деньги, усилия...), с sich - стоить того, окупаться 
umtausch: обмен
tauschen: менять
zählen: считать, считаться
zahlen: платить
bieten: предлагать
#Учёба
inserat: объявление [в газете, на сайте]
klassenarbeit: классная работа
nachhilfe: помощь с учёбой в школе, репетитор
abitur: выпускной экзамен в школе
studium: учёба в вузе
studierende: учащийся в вузе
professor: профессор
mensa: столовая [в университете или высшей школе]
referat: реферат, доклад, презентация, отдел/сектор
semester: семестр
seminar: семинар
praktikant: практикант, интерн
abschluss: окончание (школы, университета), завершение, контракт/сделка, подписание (договора)
diplom: диплом
zertifikat: сертификат
fortbildung: дополнительное образование
weiterbildung: дополнительное образование
intensiv: интенсивный
intensivkurs: интенсивный курс
kursleiter: преподаватель курса
unterrichten: вести занятия
lehrling: ученик
lehre: обучение, учёба
lehrstelle: место для обучения практиканта
zuhörer: слушатель 
teilnahme: участие
teilnehmer: участник
abwesend: отсутствующий
anwesend: присутствующий 
wiederholung: повторение
anerkennen: признавать [например, диплом]
qualifikation: квалификация
intelligenz: интеллект
#Языки
wissenschaftler: учёный
muttersprache: родной язык
fremdsprache: иностранный язык
zweitsprache: второй язык
lerner: изучающий, учащийся 
mündlich: устно
fließend: свободный [о языке], текущий
wörterbuch: словарь
lexikon: лексикон, энциклопедический словарь
dialekt: диалект
#Наука
alphabet: алфавит
wissenschaft: наука
bereich: область
gebiet: область
fortschritt: прогресс
forschung: исследование [обычно в лаборатории]
theorie: теория
studie: исследование [обычно с людьми]
zweck: цель
art: вид, тип
versuch: попытка
methode: метод
vergleich: сравнение
durchschnitt: среднее значение
durchschnittlich: среднестатистический
bericht: отчёт, рапорт, донесение
darstellung: исполнение роли, акрерская игра, изображение(как действие)
symbol: символ
nachteil: недостаток
vorteil: преимущество
fähigkeit: способность
flüssigkeit: жидкость
ursache: причина
#Исследовательская работа
verursachen: вызывать, быть причиной
wissen: знание, знать
recherche: следствие, розыск, поиск информации
inhalt: содержание [книги], содержимое, площадь, объем (численное выражение)
sinn: смысл
sinnlos: бессмысленный
sinnvoll: имеющий смысл
zusammenhang: причинно-следственная связь, зависимость
schwierigkeit: трудность
präsentation: презентация
präsentieren: делать презентацию, презентировать
thema: тема
kapitel: глава [книги]
seite: страница
abbildung: иллюстрация
zeichnung: рисунок, чертёж
bedeutung: значение
grafik: график
liste: список
tabelle: таблица
zeile: строка
Übung: упражнение
kuli: шариковая ручка
schreiben: писать, письмо [процесс]
schrift: надпись, шрифт
theoretisch: теоретический
lösen: решать, растворять
korrekt: корректный
korrigieren: корректировать, исправлять
#Работа и офис
konzentrieren:концентрировать, с sich - концентрироваться 
karriere: карьера
tätigkeit: деятельность
berufstätig: работающий [человек]
beruflich: по профессии
bewerbung: соискательство, заявка, резюме, подача резюме
lebenslauf: резюме
teilzeit: неполный день [работа]
halbtags: полдня
flexibel: гибкий, эластичный
vollzeit: полный день
auftrag: заказ, поручение
dienst: служба
dienen: служить (кем или чем-либо, в т.ч. в армии)
leisten: выполнять, совершать, делать, с sich - позволять себе ч-л
zusammenarbeit: совместная работа
verantwortung: ответственность
verantwortlich: ответственный [чаще как качество]
zuständig: ответственный [за что-либо]
zuverlässig: надёжный
kopierer: копировальный аппарат
kopieren: копировать
streiken: бастовать
#Профессии и должности
kündigung: увольнение, расторжение контракта
arbeiter: рабочий
fachmann: специалист в своей области, профи, эксперт
experte: эксперт
spezialist: специалист
profi: профессионал
meister: мастер
direktor: директор
leiten: руководить
sekretär: секретарь
profisportler: профессиональный спортсмен
ingenieur: инженер
architekt: архитектор
anwalt: адвокат
journalist: журналист
#sozialarbeiter: социальный работник
künstler: деятель искусства
fotograf: фотограф
bauer: крестьянин, работник в поле
metzger: мясник
maler: маляр
mechaniker: механик
wirt: трактирщик, хозяин частного дома
koch: повар
kellner: официант
steward: стюард
#Финансы
könig: король
lohn: зарплата/получка, заработок, вознаграждение/награда, воздаяние/возмездие 
einkommen: доход, поступать, прибывать
steuer: налог
gebühr: сбор, комиссия за что-либо
betrag: сумма [к оплате]
summe: сумма
zinsen: проценты по кредиту
zahlung: платёж
fällig: подлежащий уплате, исполнению
finanziell: финансово, с точки зрения финансов
finanzieren: финансировать
pauschal: фиксированная выплата или взнос, одинаковый для всех
geldautomat: банкомат
portemonnaie: портмоне
brieftasche: кошелёк, маленькая сумка [похожая на конверт]
bargeld: наличные деньги
schein: купюра, сияние (Sn.)
münze: монета
taschengeld: карманные деньги
trinkgeld: чаевые
beleg: квитанция, чек
quittung: квитанция
konto: счёт [в банке], аккаунт
girokonto: лицевой(текущий) счёт в банке
beratung: консультация
#Экономика
nachfrage: спрос
produktion: продукция, производство
bedarf: потребность
mangel: недостаток, нехватка
wirtschaft: экономика, хозяйство
landwirtschaft: сельское хозяйство
organisation: организация
industrie: индустрия
käufer: покупатель
handeln: действие, поступок, торговать(ся), поступать (вести себя), говориться(например в книге), обходится(с кем-либо как-то)
handel: торговля
händler: торговец
hersteller: производитель
import: импорт
export: экспорт
forum: форум
prozess: процесс
faktor: фактор
risiko: риск
mehrwertsteuer: налог на добавленную стоимость [НДС]
kosten: стоить,стоимость
krise: кризис
arbeitslosigkeit: безработица
statistik: статистика
statistisch: статистический
#Бизнес
reduzieren: сокращать, снижать
gründen: основывать
produzieren: производить
firma: фирма, компания
fabrik: фабрика
betrieb: предприятие, производство
rat: совет как группа людей
betriebsrat: производственный совет, совет предприятия
gewerkschaft: профсоюз
abteilung: отдел
arbeitsstelle: место работы, позиция
angestellte: наёмный сотрудник, «нанятый»
personal: персонал
versammlung: собрание
konferenz: конференция
planung: планирование
konkurrenz: конкуренция
marke: марка [фирма], маркировка, почтовая марка
visitenkarte: визитная карта
fair: честный, справедливый
gewinn: доход, прибыль, выигрыш
verlust: потеря, расход [фирмы]
#Время
studio: студия [офис]
vergangenheit: прошлое
zukunft: будущее
zukünftig: в будущем
zeitpunkt: момент времени, срок, дата/время (заказа)
augenblick: взгляд, момент
beginn: начало
dauer: длительность
dauernd: длительный, продолжительный
anfangs: сначала, сперва
bevor: перед, до этого
bisher: до этого, до этого момента
bisherig: бывший, прежний 
seitdem: с тех пор
nachdem: после того/этого
nachher: затем, потом, позже, после того
eher: скорее, раньше
nun: теперь, сейчас
neulich: недавно 
kürzlich: недавно 
längst: давно
häufig: часто
regelmäßig: регулярный
selten: редкий
rechtzeitig: вовремя
sobald: как только, тотчас
solange: пока, до тех пор пока, в то время ка, до тех пор пока, в то время какк
ständig: постоянный
während: во время, в то время как
mittlerweile: между тем, тем временем
nebenbei: при этом, между прочим, между делом
gleichzeitig: одновременно
innerhalb: в течение (периода времени), в рамках/границах/пределах, внутри
spätestens: самое позднее
historisch: исторический
heutig: сегодняшний
#Количество
ewig: вечный
anzahl: количество, число
insgesamt: всего, вместе
mehrheit: большинство
meisten: бóльшая часть
zahlreich: многочисленный, множественный, в большом количестве
völlig: полностью
höchstens: максимально, максимум
soviel: так много, насколько
doppel: двойной [приставка]
doppelt: в двойном размере
halb: половина, пол- (приставка, прилагательное)
geringer: маленький, небольшой, низкий (о показателях)
einbisschen: немножко
minderheit: меньшинство
minimal: минимальный
einzeln: единичный, одиночный, в розницу, отдельно, разрозненно
einzig: единственный
übrig: лишний, остальной, оставшийся
etwa: примерно
#Информация
zusätzlich: дополнительно
standpunkt: точка зрения, позиция, положение
erzählung: рассказ
bekanntgeben: объявлять 
akzeptieren: принимать, соглашаться
darstellen: изображать, представлять(из себя, собой), играть роль, запечетлевать, выражать
klären: разъяснять
analysieren: анализировать
aufschreiben: записывать
nachschlagen: быть/становиться похожим на к-л, искать (цитату), проверять в словаре/справочнике
zusammenfassen: резюмировать, подвести итоги, обобщить
per: при помощи, через
einzelheit: подробность, мелочь, нюанс
wahrheit: правда, истина
wirklichkeit: действительность, реальность
realität: реальность
realistisch: реальный, реалистичный
grund: основание, причина, фундамент, почва, фон
gegensatz: противоположность кому/чему-либо, противоречие, контраст
alternative: альтернатива
alternativ: альтернативный
relativ: сравнительно
allgemein: общий
eindeutig: однозначный
absolut: абсолютно
selbstverständlich: само собой разумеется
kompliziert: сложный
knapp: краткий. едва, в обрез, тесный (об одежде)
offenbar: очевидный
einheitlich: единый, целостный
ernsthaft: серьёзно, действительно, опасно
eventuell: возможный, возможно, в зависимости от обстоятельств
extrem: экстремальный, радикальный, предельный
maximal: максимально
#Компьютерная техника
sogenannt: так называемый
rechner: вычислительная машина, калькулятор
monitor: монитор, экран 
bildschirm: экран, монитор
lautsprecher: громкоговоритель, колонка
tastatur: клавиатура
taste: клавиша [на клавиатуре]
tippen: печатать, набирать текст на клавиатуре
festplatte: жёсткий диск [ПК]
laufwerk: заводной механизм, привод, дисковод, жесткий диск
kabel: кабель
netz: сеть [физическая]
netzwerk: сеть [компьютерная, контакты между людьми]
klick: клик
klicken: кликать, щёлкать [мышкой]
knopf: кнопка, пуговица
video: видео
kanal: канал
kassette: кассета
digital: цифровойцифровой, электронный
virtuell: виртуальный
ordner: папка (также на ПК), распорядитель
ordnen: упорядочивать
hochladen: загрузить [в интернет]
installieren: устанавливать [программу, оборудование]
integrieren: интегрировать, встраивать
löschen: удалять
#Техника
testen: тестировать
technik: техника
technologie: технология
technisch: технический
system: система
störung: расстройство, помеха
gefahr: опасность
energie: энергия
elektrisch: электрический
elektronisch: электронный
modell: модель [машины, системы]
anleitung: инструкция, руководство
bedienungsanleitung: инструкция по пользованию ч-л
anweisung: инструкция
gebrauchsanweisung: инструкция
stecker: штекер
steckdose: розетка
scheibe: шайба, кусок, ломтик, долька, стекло, мишень, диск
hörer: телефонная трубка
batterie: батарейка, аккумулятор
fernbedienung: пульт дистанционного управления
schalten: переключать, подключать
anschalten: включать
ausschalten:выключать
funktionieren: функционировать, работать [о механизме]
kaputtgehen: ломаться
kaputtmachen: ломать
teil: часть [отделяемая], деталь
detail: деталь
dicht: герметичный, плотный [например, траффик]
fest: прочный, крепкий, праздник 
flach: плоский
geeignet: пригодный, подходящий, удобный
glatt: гладкий, скользкий
locker: рыхлый, слабый, шаткий, легкомысленный
los: свободный, незакреплённый, поехали!
#Размеры и технические термины
quer: поперечный, вздорный
form: форма
länge: длина
breite: ширина
höhe: высота
fläche: площадь, повехность
messen: измерять
hälfte: половина
leistung: мощность, производительность, достижение, успех
kraft: сила
druck: давление
#Фигуры и формы
linie: линия, маршрут
abschnitt: отрезок, раздел, абзац, глава, корешок/купон/купюра, бревно
kreuz: крест
kreis: круг
runde: круг, раунд [особенно в гонках, забегах и т. п.]
punkt: точка
loch: дыра, дырка
#Местоимения
eckig: угловой, угловатый
einige: некоторые, несколько, немного, немногие, около (перед числительным)
manche: некоторые
mehrere: некоторые, несколько, различные
viele: многие
viel: много
irgend: какой-то, неопределённый, суффикс "-либо" для где-либо, как-либо, кто-либо итд
nirgends: нигде, некуда
alle: все
alles: всё
derselbe: тот же самый, та же самая, то же самое
dieser: этот, эта, это
#solch ein: такой
solcher: такой
#Наречия
welcher: какой
allerdings: впрочем, конечно, разумеется
andererseits: с другой стороны
beinahe: почти
bereits: ужé
bestimmt: определённо, определенный
dabei: при этом
deswegen: поэтому, из-за этого
diesmal: в этот раз
durcheinander: в беспорядке, спутанно
eben: ровный, гладкий, только что
ebenfalls: также, тоже
ebenso: одинаково (столько же)
einerseits: с одной стороны
extra: экстра, сверх
genauso: точно такой же
inzwischen: между тем
kaum: едва [ли], чуть не, с трудом 
meinetwegen: ради меня, я не против
möglichst: по возможности, насколько возможно
nämlich: а именно, то есть
nochmal: ещё раз
nochmals: снова
normalerweise: обычно
schließlich: в итоге, в конце концов
sowieso: так или иначе, и так и так
trotzdem: несмотря на это
übrigens: кстати
voneinander: друг от друга
weshalb: отчего?
wieso: как так?
worüber: о чём?
worum: для чего, зачем? вокруг чего? за что?
zumindest: как минимум
zunächst: сначала, для начала
Приставка ab-
abhängen: зависеть, "зависать", "тусить"
abhängig: зависимый, зависящий
unabhängig: независимый
abheben: снимать [деньги с карточки], поднимать
ablehnen: отклонять
abmachen: отвязывать, отделять
abnehmen: снимать(трубку, отпечатки, гипс), убавлять, худеть, отнимать, стихать, спадать
absagen: отменять, отказывать [обычно запись или встречу]
abschreiben: списывать, переписывать, копировать, отказывать
abstimmen: голосовать, настраивать, согласовывать
#Приставка an-
abwaschen: смывать(грязь, позор, вину), мыть(посуду, руки)
angeben: указывать, сообщать, вводить [данные]
anhaben: иметь надетым что-либо
ankündigen: объявлять заранее, оповещать, оглашать, извещать
annehmen: принимать, получать, считать, думать
anschaffen: приобретать
anschließen: подключать/подсоединять, присовокуплять, запирать, с sich - примыкать, прилегать, облегать(об одежде), включаться 
anschließend: затем/после, прилагаемый(к письму)
anschnallen: пристёгивать
ansprechen: заговорить [с кем-либо]
anstellen: нанимать [на работу]
anstrengend: напряжённый, требующий сил
anwenden: применять(к чему-либо), обычно знания, опыт, метод, правило
anzeigen: заявлять на кого-то [в полицию], подавать объявление
angabe: указание, ввод [данных]
#Приставка auf-
anstrengen:напрягать, утомлять, с sich - напрягаться, прилагать усилия 
auffallen: бросаться в глаза, быть заметным
auffordern: призывать [к чему-либо]
aufführen: играть [на сцене], указывать [в списке]
aufgeben: сдаваться
aufhalten: останавливаться [например, в отеле]
aufheben: поднимать, отменять [например, закон]
aufladen: заряжать [телефон], класть деньги на карточку/счёт
auflösen: растворять, решить [задачу, загадку]
aufnehmen: снимать кино/фото, записывать звук, принимать, вмещать, возобновлять
aufregen: возбуждать, волновать
auftreten: появляться, ступать, наступать, вести себя(в смысле показывать себя)
benehmen: поведение, манеры, с sich - вести себя на публике 
aufwachen: просыпаться
auftritt: появление, выход [на сцену]
aufforderung: призыв [к чему-либо]
#Приставка aus-
aufnahme: запись (звука, видео), приемка, набор, опись, восприятие
ausdrucken: распечатывать на принтере
auseinander: врозь, в разные стороны
ausfallen: быть отменённым [например, поезд не пойдёт], выпадать
ausgebildet: образованный
ausgezeichnet: великолепный, награждённый [званием]
ausreichen: быть достаточным
ausreichend: достаточный
ausrichten: выравнивать, выпрямлять, ровнять, организовывать, рихтовка, выравнивание
ausschließen: исключать
ausschließlich: исключительно
ausstellen: выставлять [например, товары на витрину]
aussuchen: выбирать, подыскивать
auswählen: выбирать [из списка, массы]
ausdruck: распечатка, выражение
ausgabe: издание
aushilfe: временная работа, временный сотрудник, помощник
ausnahme: исключение
aussicht: вид, перспектива
aussprache: произношение
#Приставка be-
auswahl: выбор [большой, скудный и т. п.]
beruhigen: успокаивать 
beachten: обращать внимание, соблюдать
breantragen: запрашивать
bedienen: прислуживать, обслуживать
beeinflussen: влиять, оказывать влияние
befreit: освобождённый
befriedigend: удовлетворительный (результат)
begegnen: встречать (случайно), натыкаться на к-л
begeistert: восторженный, вдохновленный, страстный
begleiten: сопровождать
begrenzt: ограниченный
begrüßen: приветствовать
behalten: оставлять себе
behandeln: обрабатывать (объекты, рану итп)
behaupten: считать, полагать
behindern: препятствовать
behindert: инвалидизированный, с ограниченными возможностями
beleidigen: оскорблять
bemerken: замечать
benötigen: нуждаться
beobachten: наблюдать, обозревать
berechnen: подсчитывать
beschädigen: повреждать
beschäftigen: нанимать на работу, занимать (ребёнка чем-либо), с sich - заниматься чем-то, быть занятым 
beschließen: постановлять
beschränken: ограничивать
besetzen: занимать, оккупировать
besitzen: владеть
besorgen: приобретать, доставать, добывать
besorgnis: беспокойство, тревога
besprechen: обговаривать
bestrafen: наказывать
betreuen: ухаживать [за ребёнком, стариком], опекать
betrügen: изменять [партнёру], обманывать
betrunken: пьяный
beweisen: доказывать, подтверждать
betreuer: опекун, тот, кто ухаживает
beweis: доказательство, подтверждение
begründung: обоснование
beschäftigung: занятие
beschäftigte: сотрудник
beschreibung: описание
besprechung: переговоры
betreuung: опека, уход
bemühen: с sich - стараться, добиваться, хлопотать 
#Приставка ein-
beteiligen: задействовать к-л, с sich - принимать участие 
einfall: внезапная мысль, вторжение, нападение
einfluss: влияние
einführung: ввод
einnahme: приём [лекарств и т. п.], доход, прибыль
einrichtung: сооружение
einzahlung: платёж, внесение денег
einfallen: вспоминаться, вторгаться, нападать
einfügen: вставлять [особенно при работе за пк]
einführen: вводить
einnehmen: принимать [внутрь себя, например, таблетки]
einrichten: сооружать, обставлять мебелью
einschalten: включать, подключать к делу [например, адвоката]
einsetzen: использовать, применять, вставлять
entsetzen: приводить в ужас
einstellen: нанимать на работу, настраивать/регулировать/налаживать (прибор), включать(радио, тв), приостанавливать
einstellung: отношение к ч-л, прекращение, прием на работу, регулировка, сцена в кино
eintreten: входить [в помещение]
#Приставка ent-
einzahlen: платить, делать взнос, совершать платёж
entwickeln: разрабатывать (программу), развивать, проявлять (какое-то качество)
entwicklung: развитие
entfernung: удалённость, расстояние от чего-либо до чего-либо
entlassung: освобождение, увольнение
entscheidung: решение
enttäuschung: разочарование
entdecken: открывать что-то новое (для себя)
entfernen: удалять
entlassen: отпускать на свободу, увольнять
entscheiden: решать
entschlossen: решительный (о человеке)
entsorgen: утилизировать
entspannend: расслабляюще
entstehen: возникать, появляться
enttäuschen: разочаровывать
enttäuschend: разочаровывающе
entschließen: с sich - решиться на что-либо 
#Приставка er-
unentschieden: ничья, не решенный
ernähren: кормить, питать, вскармливать, с sich - питаться 
ergebnis: результат
erlebnis: переживание, впечатление
erfolg: успех
ersatz: замена, суррогат
erfindung: изобретение
erhöhung: повышение, рост
erholung: отдых, оздоровление
erinnerung: воспоминание
erkältung: простуда
erklärung: объяснение
ernährung: питание
eröffnung: открытие [например, магазина]
erziehung: воспитание
erfahren: узнавать, познавать на опыте
erfinden: изобретать
erforderlich: необходимый, требуемый
erfordern: требовать, нуждаться в чем-либо
erfüllen: удовлетворять требованиям
ergänzen: дополнять, распространять
erhalten: сохранять, получать
erhöhen: повышать
erkennen: распознавать, узнавать
erleben: переживать [эмоции, события]
erledigen: решать, делать, разделываться с чем-либо
erleichtern: облегчать
eröffnen: открывать (новое - магазин, счет в банке)
erschöpft: опустошённый, истощённый
erschrecken: пугать
ersetzen: заменять
erstellen: создавать, производить
erwachsen: взрослый
erwarten: ожидать
erziehen: воспитывать
erholen: с sich - отдыхать, оздоровляться 
erkälten: с sich - простужаться 
#Приставка fest-
erkundigen: с sich - осведомляться, спрашивать, справляться, расспрашивать(bei/nach)
festhalten: крепко держать
festlegen: устанавливать, определять, указывать
festnehmen: схватить, арестовать
festsetzen: определять, устанавливать, застрять
feststehen: быть определённым, назначенным, решённым
#Приставка not-
feststellen: констатировать, определять, описывать
not: экстренный [приставка]
notausgang: запасной выход
notfall: экстренный случай
notruf: экстренный вызов
notaufnahme: неотложное отделение в больнице
#Приставка über-
nötig: необходимый, нужный
über: о, над, пере-, над- [приставка]
überzeugen: убеждать, с sich - убеждаться 
überzeugung: убеждение
übersetzer: переводчик
übernachtung: ночёвка
überraschung: сюрприз
überschrift: заголовок
überstunde: сверхурочная работа
überweisung: перевод [денежный, пациента к другому врачу]
überfahren: переехать [кого-то, что-то]
überhaupt: вообще, совсем
überholen: обгонять
überlegen: обдумать, переложить
übernehmen: перенимать
überprüfen: перепроверять
überqueren: пересекать
überraschen: удивлять
überreden: уговорить сменить своё мнение
#Приставка um-
übertreiben: преувеличивать
umdrehen: ворошить, поворачивать, переворачивать(на другую сторону), с sich - оборачиваться, разворачиваться 
umfrage: опрос
umgebung: окружение
umleitung: объезд
umziehen: переезжать, с sich - переодеваться 
umgehen: обходиться
umgekehrt: наоборот
umso: тем [например, чем больше — тем лучше]
umsonst: бесплатно, зазря, тщетно
#Приставка un-
umtauschen: обменивать
un: не- [приставка отрицания]
unglück: неудача
ungefähr: приблизительно
ungewöhnlich: непривычный
unglaublich: невероятный
#Приставка unter-
unheimlich: зловещий, тревожный
unter: под, под- [приставка]
unternehmer: предприниматель
unterhaltung: разговор
unterlagen: данные, документация, документы
unterstützung: поддержка
untersuchung: медосмотр/обследование, расследование(преступления), изучение/исследование
unterbrechen: прерывать
unterlassen: прекращать делать что-либо, «забить»
untersagt: запрещенный, недозволенный
unterscheiden: различать
unterschiedlich: различный
unterstreichen: подчёркивать
#Приставка ver-
unterstützen: поддерживать
verbrennen: сжигать, с sich - обжигаться 
verletzen: повредить, обидеть, с sich - повредиться, нанести себе травму, получить травму 
verstecken: прятать, с sich - прятаться 
verstehen: понимать, с sich - иметь хорошие отношения, не ссориться 
verhalten: поведение, с sich - вести себя (по отношению к), относиться (к) 
verhältnis: отношение(позиция), отношения/любовная связь, ситуация/обстановка, соотношение/пропорция
vertrauen: доверие, доверять
vertreter: представитель
verbindung: соединение
verletzung: повреждение, травма, нарушение
vermietung: аренда
vermittlung: посредничество, содействие, передача (как процесс)
versicherung: страховка, страхование
vertretung: представительство
verlaufen: проходить/протекать(о процессе), истечь(о сроке годности), с sich - заблудиться пешком 
verbinden: соединять
verbrauchen: расходовать, потреблять [например, бензин]
verbringen: проводить [время]
vergeblich: зря
vergrößern: увеличивать
verhindern: препятствовать, предотвращать
verlangen: требовать
verlängern: продлевать
verlassen: покидать, оставлять [уходить]
verliebt: влюблён
vermeiden: избегать
vermissen: скучать
vermuten: предполагать
vermutlich: преположительно
vermutung: предположение
annahme: предположение
verpacken: упаковывать
verpflegen: кормить [глобально], снабжать продовольствием
verpflichten: обязывать 
verpflichtet: обязанный, ответственный
verraten: предавать
versäumen: упускать [шанс]
verschreiben: прописывать [например, лекарство], предписывать
verschwinden: исчезать
versichern: страховать [оформлять страховку], уверять
versprechen: обещать
verteilen: распределять, делить
vertreten: представлять (кого-либо, что-либо), замещать
#Приставка vor-
verwenden: использовать (для конкретной цел цели), применять
vorbereiten: подготавливать/готовить, с sich - готовиться к чему-либо 
vorstellung: представление [кого-то кому-то]
vorstellungsgespräch: собеседование
vortrag: лекция, доклад, реферат
vorwurf: черновик
voraussetzung: условие, предпосылка
vorbereitung: подготовка
vorfahrt: преимущество проезда [например, на главной дороге]
vorschrift: предписание
vorallem: прежде всего
voraus: заранее, загодя, вперёд (с глаголом движения)
voraussichtlich: преположительно, вероятно, ожидаемо
vorder: передний [приставка]
vorhaben: планировать, собираться сделать
vorhin: только что, давеча
vorkommen: случаться, происходить
vorläufig: предварительный, временный, не конечный вариант
vorlesen: читать вслух
#Приставка zu-
vorschlagen: предлагать
zufall: случайность
zugang: доступ
zuschauer: зритель
zuschlag: надбавка, дополнительная плата
zustand: состояние
zustimmung: согласие
zufällig: случайный
zugänglich: доступный
zugehen: направляться, подходить, приближаться к чему-либо/кому-либо, закрываться
zunehmen: набрать вес, потолстеть
zusagen: обещать, соглашаться
#Da-
zustimmen: соглашаться
dafür: для этого, за (в обмен на что-либо)
dagegen: против этого, против (чего-либо)
daher: поэтому, оттуда
dahin: туда
damit: тем самым, чтобы
#Hin- und her-
danach: после
her: сюда
herunter: вниз
herunterfahren: ехать вниз [например, на лифте]
herunterwerfen: бросить вниз [сюда, в сторону говорящего]
herausfinden: выяснять, находить
herausforderung: вызов [к совершению чего-то непростого]
hierher: сюда, her
hinterher: позади
hin: туда, прочь
hinunterwerfen: бросить вниз [отсюда, в сторону от говорящего]
hinweisen: указывать/ссылаться на ч-л
#Je-
hinweis: указание, намек, замечание, ссылка, индикация
je: когда-нибудь [уже], чем
jede: каждая
jeder: каждый
jedes: каждое
jedoch: всё-таки
jemals: когда-нибудь [в прошлом или будущем]
jeweils: каждый, каждый раз
jeweilig: соответствующий, данный, действующий
jederzeit: в любое время
#Частицы
jedesmal: каждый раз (2 слова)
bloß: голый, обнаженный, босой, только, лишь, же, просто
gar: совершенно, совсем
mal: раз, частица -ка
ob: частица «ли»
#Вводные слова
ziemlich: довольно, достаточно
alsob: как будто, словно (2 cлова)
falls: в случае, если
indem: тем, что (вводное слово перед объяснением того, что нужно сделать)
obwohl: хотя
sodass: так что
#Двойные союзы
statt: вместо
#entweder oder: или ... или (2 слова)
#je desto: чем ... тем (2 слова)
#sowohl als auch: не только, но и (3 слова)
#um zu: чтобы (2 слова)
#weder noch: ни ... ни (2 слова)
krumm: согнутый, искривленный
verfassen: сочинять (письмо, рассказ), составлять, beitragen: вносить вклад, содействовать, постить 
beitrag: взнос, вклад, очерк/статья/пост)
veröffentlichung: публикация, издание
verweisen: ссылаться на, обращать внимание, рекомендовать, направлять к кому-то (an, auf)
aspekt: точка зрения, сторона явления
etliche: около(с числительным), некоторые, несколько
#ein paar: пара, несколько (2 слова)
zwar: правда (во фразах правда... но...)
#und zwar: а именно, и притом, то бишь (2 слова)
sowie: а также, равно как и, как только
denen: их, них
entsprechen: соответствовать, удовлетворять 
beziehungsweise: точнее говоря, вернее, или же
na: м-да, ну!
#na und: ну, и! (2 слова)
erscheinen: появляться, показываться, выходить (из печати)
dadurch: в следствии/из-за этого, тем самым
jene: та, оная
jener: тот, оный
jenes: то, оное
naja: междометие неуверенности (2 слова)
bilden: создавать, формировать, составлять, образовывать (в т.ч. давать образование)
vergehen: проступок, преступление, пропадать(проходить - о боли, желании, аппетите, времени)
betreffen: касаться ч-л, относиться к кому-то/чему-то, [по]страдать (от стихийног бедствия)
gewiss: наверное, вероятно, несомненно, определенно
wesentlich: фундаментально, в сущности 
ergeben: верный, преданный, покорный
begriff: понятие, представление
begreifen: понимать, осознавать, усваивать, постигать
rahmen: рама, рамка(также в переносном смысле - в рамках, за рамками, рамочное соглашение)
jährig: годовалый
bezeichnen: обозначать, описывать, называть, помечать, отмечать
insbesondere: особенно, в особенности
wobei: причем?
betrachten: рассматривать, анализировать, расценивать
enthalten: содержать/заключать в себе, вмещать, с sich - воздерживаться, удерживаться, уклоняться 
erfolgen: следовать (из ч-л или за ч-л), осуществляться, производиться, проходить, происходить
darum: за это, ради этого, для этого, вокруг этого
zudem: к тому же
verfügen: обладать, иметь в своем распоряжении (über)
vorliegen: предъявлять, представлять (доклад, документы)
einsatz: применение, внедрение, ввод в действие, ставка в игре, заклад, залог, вставка в одежде
anwendung: применение, использование, употребление
beziehen: обивать/обтягивать (стул тканью), с sich - иметь отношение к к-л/ч-л, ссылаться на 
grundsätzlich: в принципе, в целом, кардинально, базовый, принципиальный
verfahren: метод, процесс, технология, процедура, способ 
vorhanden: имеющийся в наличии, существовать, наличествовать
künftig: будущий, предстоящий, грядущий, впредь 
betonen: делать акцент, выделять, подчеркивать, отмечать
dennoch: тем не менее, все-таки, однако
zugleich: вместе с тем, в равной мере, одновременно
maßnahme: мероприятие, мера (например черезвычайная мера)
maß: размер, мерка, масштаб, граница/предел, мера/степень, литровая кружка
eignen: с sich - подходить(к чему-либо, для чего-либо), годиться 
umfassen: охватывать, обхватывать, обнимать, содержать в себе
ebene: плоскость, равнина, уровень, сфера/область
zuvor: прежде, раньше, до этого времени
betragen: исчисляться,равняться, составлять какую-то сумму
ahnen: ощущать, предчуствовать, подозревать
teilweise: частично
aufbauen: возводить, строить/надстраивать, выстраивать(отношения), накачивать(мышцы)
durchführen: выполнять/исполнять (план, приказ), исколесить/объехать
durchaus: совсем, совершенно
eingehen: соглашаться, заключать (собз, договор), подробно останавливаться, входить (в историю, в употребление)
blicken: бросать взгляд, глядеть, выглядывать
konkret: конкретный
ehemalig: бывший, прежний
stets: всегда
drohen: угрожать
staatlich: государственный
lediglich: лишь, только, исключительно
unmittelbar: непосредственный, немедленный
#somit als auch: как...так и... (3 слова)
darunter: ниже, под, среди(кого-то, чего-то), в том числе, меньше/дещевле
konzept: концепция/программа, конспект/план, набросок/черновик
bewusst: осведомленный
immerhin: все-таки, тем не менее, все-же, как-никак
klassisch: классический
betreiben: заниматься ч-л, приводить в действие, промышлять ч-л
weiterhin: дальше, впредь, еще
zelle: клетка (биолог.)
ansatz: насадка, начало, закон, осадок, поготовка, разработка, склонность
umstand: обстоятельство
ermöglichen: позволять, делать возможным, предоставлять возможность
irgendein: какой-либо
erneut: снова, вновь, повторный, обновленный
grundlage: основа, база
gemeinde: муниципалитет, община, паства
erwähnen: упоминать
wiederum: снова/опять, наоборот/напротив/с другой стороны
position: позиция
soweit: насколько/настолько
rasch: быстрый, скорый, стремительный
sicherlich: определенно
geraten: оказываться, быть похожим (на кого-либо), выходить из себя, впадать(в гнев, в панику)
sicht: вид, точка зрения
vielmehr: скорее(в большей степени), вернее, напротив/наоборот
bewertung:оценка, рейтинг, отзыв
berücksichtigen: учитывать, принимать во внимание
verstopfen: закупоривать/закупорка, засорять/засор, затыкать, закладывать/заложенность(об ушах, носе)
hinfliegen: шмякнуться, лететь к-л
zerfließen: растекаться
zeiger: указатель, стрелка прибора
wirbel: водоворот, вихрь, макушка, барабанная дробь
#wirbeln: проноситься вихрем, завихрение
uhrwerk: часовой механизм
rotieren: вращаться
ekel: омерзение, тошнота, отвращение
ekeln: с sich - брезговать, испытывать отвращение 
eklig: омерзительный 
anhalten: переставать делать ч-л, требовать, останавливать/продолжать/сохранять
dringen: требовать/настаивать.уговаривать, проникать
sanft: кроткий, нежный
rollen: катить, сворачивать
verschlingen: поглощать, проглатывать
serviette: салфетка
kochfeld:  кухонная плита
zentner:  50 килограмм 
schnaphen: выгодная покупка
eigentumswohnung: кондоминиум 
wohnfläche: жилая площадь 
#einfamilienhaus: частный дом
reihenhaus : таунхаус 
mehrfamilienhaus: многоквартирный дом
immobilien: недвижимость 
neubau: новостройка
abgemeldetsein: быть зарегистрированым (2 слова)
spitze: вершина, верхушка, кончик, шпиль, мунштук, кружево, топ!
bislang:до сих пор, доныне
erheblich: значи́тельный,суще́ственный
vermitteln: передава́ть(ч-л к-л. зна́ния, о́пыт), посре́дничать, посре́дничество, соде́йствие, переда́ча/сообще́ние(telekom)
herrschen: госпо́дствовать (над к-л/ч-л), пра́вить, ца́рствовать, повелева́ть, стоя́ть(о пого́де)
angriff: [за]хват, агре́ссия, нападе́ние/ата́ка, ка́чество, ощуща́емое на о́щупь, возде́йствие, зацепле́ние, сочлене́ние(тех.), корро́зия  
angreifen:  атакова́ть, критиковать, хватать(ся), воздействовать, расходовать, разрушать, ослаблять
erheben: заяви́ть (о краже)(юр.), взима́ть(налог), возвыша́ть, возводить (в степень), с sich - возвышаться, восставать, вставать  
anteil: часть, пай, уча́сток, уча́стие (сочу́вствие, долевое), кво́та, компоне́нт, лими́т, составля́ющая, фа́за/фра́кция (хим.)
verfolgen: наблюда́ть,просле́живать (ч-л), следи́ть (за к-л/ч-л), пресле́довать/травить, приде́рживаться (к-л ку́рса), проводи́ть(поли́тику)
behandlung: лече́ние, обраще́ние/обхожде́ние(с к-л/ч-л), разбо́р/рассмотре́ние, подхо́д, отноше́ние, тракто́вка  
lauf: бег, проце́сс, движе́ние/ход/тече́ние(реки́, вре́мени), рабо́та(механи́зма), ру́сло(реки́)
empfinden: чувствовать, ощущать, воспринимать, испытывать чувства 
erkenntnis: осознание, прозрение, интуиция
angesichts:в свете ч-л, в связи с ч-л, с учетом ч-л, перед лицом ч-л
analyse: анализ, исследование, химсостав 
vorsitzende: председатель
vorsitzen: председательствовать, возглавлять (собрание)
prägen: формировать, чеканить, тиснить, формулировать, образовывать ч-л 
nicken: кивать, кивок, тангаж
kassenbeleg: чек в магазине
kassenbon: чек в магазине
kassenzettel: чек в магазине
verstärken: укреплять, усиливать, обострять(боль, простуду)
geruch: запах
duft: аромат
aroma: аромат
hauch: слабый запах
stank: вонь
objekt: объект
vorsehen: планировать, предусматривать, с sich - остерегаться
bezug: наволочка, пододеяльник, чехол, футляр, набивка, получение(пенсии, пособия)
regelung: [у]регулирование, налаживание, нормализация
sozusagen: так сказать
anlegen: швартовка, разбивка(сада), посев, закладка(камня), прикладывать, накладывать(повязку), приставать, делать вклад, устраивать
komplex: комплекс, комплексный/нетривиальный
fein: мелкий, изящный, утонченный, хрупкий, нежный
definieren: давать определение, определять
orientieren: направлять, ориентировать
weitergehen: продолжаться
weitgehend: значительный, широкий, далеко идущий, в значительной мере
insofern: в этом отношении, в той мере; постольку...als...
tätig: деятельный, активный, работающий в качестве к-л
erstmals: впервые
geografie: география
geige: скрипка
hintergrund: фон/задний план, подноготная
übertragen: переносить, передавать, поручать, транслировать
hingegen: зато, наоборот, напротив
vornehmen: предпринимать, осуществлять
aufweisen: иметь, обнаруживать, предъявлять/показывать, проявлять, подстрекать
geistig: духовный, ментальный
anschauen: с sich - просматривать (список, кино, альбом) 
jährlich: ежегодный
eigenschaft: качество, свойство, фича
hereinkommen: входить внутрь
derjenige: тот/та/то
bildung: воспитание, формирование, образование, организация
erzielen: достигать, добиваться ч-л
grauen: ужас, испуг
horror: ужас
befehlen: приказывать
befehl: приказ
weltraum: космос
substantiv: существительное
definitiv: определенный
kichern: хихикать
giggeln: хихикать
gekicher: хихикание
bummeln: бездельничать, прогуливать
überfliegen: пролетать
hafer: овес
brei: каша
grütze: каша
buchweizen: гречка
grieß: манка
hirse: пшено, просо
vorhang: занавес
alptraum: кошмар
komma: запятая
feststecken: застревать
notdienst: аварийная служба
zwangsläufig: неизбежный, принудительный
waage: весы
beruhen: основываться на ч-л
berühren: трогать, касаться
kohl: капуста
kraut: капуста
steigern: повышать, увеличивать, усиливать, эскалировать
wichsen: полировать, чистить обувь, вощить, дрочить
wischen: вытирать, протирать протирать, свайпить
gehirn: мозг
klamotten: шмотки
börse: биржа
wachen: бодрствовать, дежурить
wüste: пустыня
verfügbar: наличествующий
#gründling: пескарь
wal: кит
delphin: дельфин
oktopus: осьминог
#roche: скат
muräne: мурена
barsch: окунь
cachalot: кашалот
pottwal: кашалот
krabbe:	краб
#rotbarsch: морской окунь
krebs: рак
karpfen: карп
thunfisch: тунец
#hecht: щука
tintenfisch: кальмар
#karausche: карась	
meduse: медуза
qualle: медуза
forelle: форель
muschel: мидия
auster: устрица
#wels: сом
garnele: креветка
#brassen: лещ
languste: лангуст
lachs: лосось	
#hummer: омар
lobster: омар
stör: осетр	
sägefisch: рыба-пила
kabeljau: треска	
schwertfisch: рыба-меч
makrele: скумбрия	
#felchen: сиг 
#renke: сиг
haifisch: акула
heilbutt: палтус
#plötze: плотва
#rotauge: плотва
dorsch: навага
kapelan: мойва
#sterlet: стерлядь
zander: судак
seezunge: морской язык
scholle: камбала
rotzunge: камбала
katfisch: зубатка
seewolf: зубатка
hering: сельдь
#stint: корюшка
#meeräsche: лобан
seenadel: рыба-игла
aal: угорь	
#strömling: салака
#neunauge: минога	
goldbrassen: дорада
seepferdchen: морской конек	
#pollak: минтай
seestern: морская звезда	
#schmerle: голец
#seeteufel: морской черт	
barrakuda: барракуда
brett: доска
strudel: вихрь, водоворот
#Duolingo
abgeordnete: депутат, делегат
abordnen: делeгировать, направлять, слать
abstürzen: срываться, падать (со склалы, обрыва)
abiball: выпускной бал
absatz: абзац, каблук, уступ/выступ, площадка/ступень лестницы
abtrocknen: высыхание, вытирать, высушивать
adler: орел
affe: обезьяна
afrika: африка
akku: аккумулятор
akte: акт, дело, материалы по делу, документы
aktentasche: портфель
album: альбом
allergie: алергия
altmodisch: старомодный
ananas: ананас
anfahren: наезжать(совершать наезд на к-л). доставлять, приезжать, запускать двигатель
anmelden: докладывать, прописывать, регистрировать, сообщать
anhang: дополнение, приложение (к письму, договору), близкие, последователи, болельщики, аппендикс
anprobieren: примерять, мерять
anstatt: вместо
anziehen: надевать(одежду, обувь), натягивать 
arbeitgeber: работодатель
arbeitszimmer: домашний офис
architektur: архитектура
armband: браслет
attraktiv: привлекательный (о человеке)
aufführung: поведение, возведение(здания), постановка/представление(кино, театр)
aufgehen: открываться, раздвигаться(о занавесе) приходить в голову, всходить(о солнце, семенах), распускаться/расцветать
aufwaschen: мыть поверхность (пол), мыть посуду(юж.нем.)
auswaschen: вымывать/отмывать (рану, стакан)
aufsatz: школьное сочинение, статья, блюдо(еда), ваза
aula: аудитория
ausländerbehörde: отдел виз и регистрации иностранцев
ausrede: оправдание
ausschlafen: просыпать. проспать
ausverkauft: распродано
ausziehen: снимать (обувь, одежду)
azubi: ученик техникума
badeanzug: купальный костюм
badehose: плавки (для купания)
kaufmann: коммерсант, торговец
basilikum: базилик
baumwolle: хлопок(материал)
bayern: Бавария
becher: стаканчик(бум, пласт), чарка
begabt: одаренный
belegen: занимать место, покрывать/выстилать(mit), подтверждать что-либо чем-либо(durch)
bellen: лаять
bergsteigen: восхождение в горы
berliner: пончик
bestellung: заказ
lacken: простынь
bettlacken: простынь
bettdecke: покрывало, одеяло
beunruhigen: беспокоить, настораживать, тревожить
bewaffnen: вооружать
bewaffnet: вооружеbewaffnet: вооруженныйй
bischof: епископ
bonus: бонус
brauerei: пивоварня
brav: послушный
bretzel: б(п)рецель
brunnen: колодец
brüllen: рычать
buchladen: книжный магазин
bundeskanzler: глава правительства(герм.)
bundestag: парламент (герм.)
bundesland: фед. земля (герм.)
bügeln: гладить(утюгом), глажка 
bügel: вешалка
bürgermeister: бургомистр, мэр
cent: цент
chemie: химия
china:китай
chinesisch: китайский
chor: хор
clown: клоун
comics: комикс
croissant: круассан
curry: карри
date: свидание
decken: накрывать (одеялом, на стол)
demnächst: скоро
demokratie: демократия
deprimiert: подавленый, удрученный
diebstahl: кража
dokufilm: документальный фильм `
dom:кафедральный собор
drache: дракон 
drachen: воздушный змей
dran: быть на проводе, имеющий ход (в игре)
#drogeriemarkt: 
durchstellen: переводить звонок (переключать на другой телефон)
durchwahlnummer: добавочный/внутренний номер телефона
duschen: принимать душ
döner: донер кебаб
edelstahl: нержавейка
eidechse: ящерицв
eigen: присущий/характерный
eigener: свой
einchecken: чекиниться, регистрироваться(в отеле)
eineinhalb: полтора
einhalten: соблюдать(сроки, условия) выполнять (обещание), придерживаться(взглядов)
einheimische: местный
einkaufszettel: список покупок
einloggen: логиниться
einlösen: получать деньги по чеку/векселю, выкупать залог, выполнять обещание/сдержать слово
einreichen: предоставлять/подавать заявление, документы
einschlafen: засыпать
eintrittskarte: входной билет
einweihungsparty: вечеринка по поводу въезда в новое жилье
einzimmerwohnung: квартира-студия
eiskalt: морозный. студеный, ледяной
eislaufen: кататься на коньках
ekelhaft: отвратительный
elefant: слон
empfindlich: чувствительный
ente: утка
entrümpeln: очищать от хлама(подвал, гараж)
entschädigen: компенсировать, возмещать, восполнять ущерб
entspannen: ослаблять, расслаблять,снимать напряжение, разряжать(атмосферу, обстановку)
entwerten:компостировать (билет), гасить(марку), обесценивать/девальвировать
erdbeere: клубника/земляника
erdkunde: география
erlassen: издавать (закон, декрет), освобождать/снимать(наказание, выговор)
erstklassig: первоклассный
erwischen: хватать, ловить (на мечте преступления), успевать (на поезд)
esszimmer: столовая комната
eule: сова
exotische: экзотический
experiment: эксперимент
fahrradfahren: ездить на велосипеде
fahrschein: проездной документ
fahrt: поездка
fallschirmspringen: прыгать с парашютом
familienfest: семейный праздник
farbstift: цветной карандаш
faszinierend: захватывающий, завораживающий
federball: бадминтон
feder: перо
fell: мех, шерсть, шкура
ferienhaus: дача, загородный дом
ferkel: поросенок
fern: удаленный, далекий, далеко
fernsehserie: ТВ сериал
#fertig machen
fertiggestellt: завершенный, законченный
fettarm: обезжиренный
feuerwerk: феерверк
fischen: рыбачить
fit: в форме
fitnessstudio: спортзал
#fix und fertig
flamingo: фламинго
fliege: муха, галстук-бабочка
flugbegleiter: стюард (авиа)
fluggesellschaft: авиакомпания
folie: слайд, пленка(упаков.), фольга
frankreich: Франция
#französisch
freuen: радовать, с sich - радоваться/предвкушать
#freut mich
frikadelle: тефтель, фрикаделька, котлета, биток
frosch: лягушка
#frühstücksflocken
fuchs: лиса
futter: корм (для животных)
fühler: антенна (у насекомых)
füllen: наполнять
füllung: наполнение
gans: гусь
gassi: выгул (собаки)
gebraucht: использованный
#geburtstagskarte
geduldig: терпеливый
geheimzahl: пин-код
geldbeutel: кошелек
geldstrafe: штраф
gemein: низкий, подлый, вульгарный
general: генерал (в армии)
genf: Женева
genie: гений
geräusch: шум
geschichtsbuch: книга.учебник по истории
geschäftlich: служебный, по работе
#geschäftsfrau: 
geschäftsmann: бизнесмен
gespenst: призрак, привидение
gipsverband: гипс (повязка)
giraffe: жираф
glücksbringer: талисман
glühwein: глинтвейн
golden: золотой
grammatik: грамматика
grauenhaft: ужасный
#griechisch
#grillparty
groß: высокий(о человеке)
großartig: великолепный
#großbritannien
großzügig: щедрый
grundschule: начальная школа
grüne: зелень
gurke: огурец
gurkensalat
#rutsch
gutschein: подарочный купон(сертификат, карта)
gürtel: ремень
#haarreif
halbzeit: тайм (в игре) 
hamster: хомяк
#handball
handlung: лавка(магазин), сюжет, действие
handschuh: перчатка
handtasche: дамская сумочка
#handynummer
hauptfach: основная специальность/главный учебный предмет
hausarbeit: работа по дому, домашняя работа
#hausnummer
#heimtrainer: велотренажер
herrlich: великолепный, превосходный
herum: вокруг, кругом
hervorragend: выдающийся, незаурядный
hexe: ведьма
hilfreich: полезный, готовый помочь
#Hin- und Rückfahrt
hinaus: наружу
hinausgehen: выходить (из дома, за пределы)
hochgehen: подниматься (на ч-л), бушевать (о море)
#hockey
#holländisch
horrorfilm: фильм ужасов
hort: оплот, продленка (в школе, детсаду)
hosentasche: карман
hubschrauber: вертолет
huhn: курицв
hurra: ура!
hörsaal: аудитория, лекционный зал
#indien
#indische
#indian
#informatik: информатика
#internetverbindung
#irisch
#irland
#island
#italienisch
jagen: охотиться
jahrestag: годовщина
#japan
#japanisch
#jazz
jobinterview: собеседование
joghurt: йогурт
jugendlich: молодежный 
jura: юриспруденция
jäger: охотник
kaiser: император, кайзер
#kaiserthermen
#kanada
#kanadier
kaninchen: кролик
kanzler: канцлер
kappe: капюшон, колпак, шапка, колпачок
#karibik
#karnevalsparty
karnevalsumzug: карнавальный парад
#kartoffelsalat
karton: картонная коробка
keks: печенье (штука)
#kinderbuch
#kinderstuhl
#kinderzimmer
#kinokarte
klassentreffen: встреча класса (через N лет)
kleingeld: сдача
klimawandel: изменение климата
kloster: монастырь
kneten: лепить, месить/вымешивать(тесто), массировать
knoblauch: чеснок
koalition: коалиция
kochbuch: кулинарная книга
kochlöffel: поварешка
kofferausgabe: выдача багажа
kofferraum: багажник авто
kommode: комод
komödie: комедия
konditorei: кондитерская
konservativ: консервативный
konsole: консоль, кронштейн
kontinent: континент
#kontonummer
kontrolle: контроль, проверка
kopfhörer: наушники
kopfkissen: подушка
kopfschmerzen: головная боль
krafttraining: силовая тренировка
krawatte: галстук
kreuzen: перекрешивать, крестить, ставить крестик (в графе)
kreuzfahrt: круиз
kreuzung: перекресток, пересечение, гибрид
krokodil: крокодил
kugel: шар, ядро, пуля
kuh: корова
#kunstmuseum
kuschelig: мягкий, пухлый, уютный
käfig: клетка
kämmen: причесывать
#käsebrot
#käsespätzle
#köln
#küchensachen
#küchenwaage
labor:лаборатория
ladegerät: зарядное устройство
landkarte: карта (географическая)
leberwurst: ливерная колбаса
#lederjacke
leid: горе
leine: поводок, канат, веревка, линь
Leopard: леопард
leuchtturm: маяк
liberal: либеральный
lieferservice: служба доставки
lila: лиловый
lineal: линейка
linguistik: лингвистика
#lissabon
lockig: вьющийся, кучерявый (о волосах)
luftballon: воздушный шарик
#luxemburg
#luxushotel
löwe: лев
#mittagszeit: время ленча
mittelalter: средние века
#mittelfeldspieler
#mittelmeer
mitternacht: полночь
mobilbox: голосовая почта
moped: мопед
moschee: мечеть
motiviert: мотивированный
mähen: косить (траву,газон)
möbelhaus: мебельный магазин
müllbeutel: мешок для мусора
mülleimer: мусорное ведро
#münchen
nachname: фамилия
nachrichtensprecher: ведущий новостей
nachsehen: просматривать, смотреть в справочнике/словаре/..., прощать, относиться снисходительно, смотреть вслед
nachtisch: десерт
nacken: шея (затылок)
#namibia
nebenfach: боковой ящик, вторая специальность, второстепенный предмет(в университете)
nerven: нервировать, раздражать
nervig: жилистый, энергичный, действующий на нервы
nest: гнездо
#neuseeland
nickerchen: дрема, короткий сон
#nordamerika
notizbuch: записная книжка
nudelholz: скалка
null: ноль
#nussallergie
obdachlos: бездомный
obstsalat: фруктовый салат
ofen: духовка
ohrring: серьга
#oktoberfest
omelett: омлет
ostern: пасха
#ostsee: балтика
packung: упаковка
panda: панда
panik: паника
papa: папа
papagei: попугай
parkplatz: парковка
partei: партия (политическая)
#pass auf
#passfoto
pastete: паштет, слоеный пирожок с начинкой
pausenbrot: школьный ланч, перекус
philosophie: философия
physik: физика
pinguin: пингвин
pirat: пират
#pizza
platzanweiser: капельдинер, распорядитель (в зале), билетер
plaudern: болтать
plus: плюс
#podcast
#polen
politikwissenschaft: политология
#polnisch
pommes: картофель фри
#popcorn
popmusik: попса
#prag
prinz: принц
prinzessin: принцесса
#proseminar
psychologie: психология
pudel: пудель
puppenspieler: кукловод
puppentheater: кукольный театр
#puzzle
quatsch: чушь
quell: ручей, причина
quelle: [перво]источник, родник (die), ручей, причина (der)
radiergummi: ластик
#radtour
rastplatz: площадка для отдыха (на автобане)
ratte: крыса
recherchieren: расследовать, вести поиск
rechtschreibung: орфография, правописание
recyceln: перерабатывать
regenmantel: дождевик(плащ)
regenschirm: зонтик
regieren: управлять
regierung: правительство
reifenpanne: сдутая шина
reinkommen: входить
#reiseadapter
reisetasche: баул, саквояж, дорожная сумка
#reisezentrum
#rhein
riesenrad: колесо обозрения
#rinderbraten
rindfleisch: говядина
riskant: рискованный
ritter: рыцарь
roboter: робот
#rockkonzert
rollschuhe: роликовые коньки
rolltreppe: эскалатор
rosa: розовый
rotkäppchen: Красная Шапочка
rotwein: красное вино
#router
ruf: возглас, восклицание, вызов, крик, звонок
#rugby
ruhen: покоиться(на ч-л), основываться, бездействовать, отдыхать
runterfallen: падать
#russland
räumen: освобождать, убирать, опустошать
#römisch
röntgenbild: рентгеновский снимок
#rügen
sakko: пиджак
#salami
sandale: сандалия, босоножка
#sandwich: сэндвич
sauerkraut: квашеная капуста
#sauna
schach: шахматы
schaf: овца 
schal: шарф
schatz: сокровище, дорогая/ой!
scheck: чек(банк.), платежное поручение
scheußlich: ужасный
schiedsrichter: рефери, судья (в игре)
schildkröte: черепаха
schlafanzug: пижама
schlagzeug: барабанная установка
schlosser: слесарь
schmerzen: болеть, ныть, саднить
schnarchen: храп, храпеть
schnecke: улитка
schneemann: снеговик
schneidebrett: разделочная доска 
schneider: портной
#schottland
schrebergarten: городской садовый участок/огород
schreibblock: блокнот
schreibtisch: письменный стол
schublade: выдвижной ящик
schulranzen: школьный ранец
schuppe: чешуя, чешуйка
schwager: шурин, деверь
schwarzfahren: ездить зайцем
#schwarzwald
#schweden
schweinefleisch: свинина
#schweiz
schwert: меч
schwiegereltern: тесть, теща, свекр и сверовь, собирательно
schwimmbecken: бассейн(непосредственно)
#schwimmsachen
schwindelig: головокружительный, подверженный головокружению, (mir wurde ...) у меня кружится голова
Schwägerin:невестка, сноха, своячница
schwänzen: отлынивать, прогуливать
#schäferhund
schüchtern: застенчивый
schürze: фартук 
segeln: плавать под парусом
seide: шелк 
sekt: шампанское
#semesterbeginn
#semesterende: конец семестра
senf: горчица
#shampoo
shorts: шорты
silber: серебро
silbern: серебряный
silvester: новый год
sitzplatz: сидячее место
#skateboard
#software
sommerjob: подработка на каникулах
sondern: но скорее
sonnenbrand: солнечный ожог
sonnenbrille: солнечные очки
sonnencreme: крем от солнца 
sonntags: по воскресеньям
#spa: спа
spaghetti: спагетти
spargel: спаржа
spazieren: прогуливаться
speck: бекон
spende: пожертвование
spenden: жертвовать (донатить)
spinat: шпинат
spinne: паук
spinnen: прясть, плести, ткать, выдумывать/чудить/сходить с ума
sporthalle: спортзал
#sportverein: спортклуб
spülbecken: кухонная раковина/мойка
spülmaschine: посудомоечная машина
staatsangehörigkeit: гражданство
stabil: стабильный, устойчивый, крепкий
stadtführung: экскурсия по городу
#stadtmuseum
stadtrundgang: пешая экскурсия по городу
stadtviertel: городской квартал
stadtzentrum: центр города
staffel: сезон (сериала), ступень, уступ, эстафета, эшелон(авиа), ярус
stall:конюшня,стойло,хлев,птичник
steigend: возрастающий, восходящий
Stiefmutter: мачеха
stiefvater: отчим
stollen: рождественский фруктовый кекс
stoppschild: знак остановки
stornieren: отменять, расторгать/аннулировать(контракт)
stricken: вязать(на спицах)
studentenausweis: студенческий билет
studentenwohnheim: студенческое общежитие
studienplatz: место в вузе (поступать)
stundenplan: расписание
stur: упрямый, упертый
surfbrett: доска для серфинга
#syrien
#Südafrika
#südamerika
tagebuch: дневник
tank: бак, танк, цистерна
taschenrechner: калькулятор
taube: голубь
taxifahrt: поездка на такси
taxistand: стоянка такси
technoparty: рейв
teekanne: чайник
teig: тесто
telefonnummer: телефонный номер
tierarzt: ветеринар
tiergarten: зоопарк
tierheim: приют для животных
# tierpfleger: 
# toast: тост(хлеб)
# toaster: тостер
tofu: тофу
tonne: тонна, бочка, контенер
torwart: вратарь
trampolin: трамплин
trauben: виноград
traumberuf: работа мечты
#trier
trikot: майка, футболка, трико, трикотаж
trimmen: подгонять, приучать, дрессировать
trockner: сушилка
trösten: утешать
turnschuhe: спортивная обувь
tänzer: танцор
#türkei
#ufo
umkleidekabinen: кабины для переодевания, примерочныe
umweltfreundlich: благоприятный для окружающей среды
unertragbar: невыносимый
#ungarn
ungeheuer: монстр, чудовище
unglücklich: несчастливый, неудачный
unhöflich: невежливыйЮ неучтивый
uni: университет
#uniabschluss
unordentlich: неряшливый, беспорядочный
#unser
unsinn: чушь
unterwäsche: нижнее белье
unvorbereitet: без подготовки, врасплох
#vatertag
vegan: веган
#venedig
ventilator: вентилятор
verkleiden: переодевать, с sich - наряжаться/переодеваться
verloben: обручаться
vermischen: смешивать, перемешивать
verschenken: раздаривать, передаривать, отдаю даром(zu)
versichert: застрахованный
verspannt:натужный
verspäten: с sich - опаздывать
verteidiger: защитник(в том числе в спорте)
verwandeln: превращать, преображать
verwählen: ошибаться в наборе тел. номера
verwöhnen: баловать
verärgert: разозленный, раздосадованный
videospiel: видеоигра
vielfalt: многообразие, разнообразие, дайверсити
viereck: четырехугольник
viereckig: четырехугольный
#villa
vokabel: слово
vorbeikommen:заезжать, заходить, заглядывать к к-л
vorlesung: лекция
vorstellen: представлять
vorsatz: замысел, намерение, проект, план, форзац
vorzeigen: предъявлять (паспорт, проездной)
wachsend: растущий
wandern: бродить, ходить в поход, странствовать, гулять
#warschau
wartezimmer: комната ожидания
waschbär: енот
waschen: мыть, стирать, умывать, стирка, умывание
waschmaschine: стиральная машина
#wasserflasche
wasserkocher: электрический чайник
wassermelone: арбуз
wegbeschreibung: маршрут
weh: боль, скорбь, печаль
weihnachten: рождество
weiterlesen: продолжать чтение
weißbier: пшеничное пиво
weißwein: белое вино
weltreise: кругосветное путешествие
wessen: чей
wiederherstellen: восстанавливать, реставрировать
wiederkommen: возвращаться
#wiederzusehen
#wien
#wiesn-herz
#winterstiefel
wlan:WiFi
wochenmarkt: рынок выходного дня
wofür: ради чего?
wolf: волк
wonach: после чего?
woran: в чем? к чему? на чем?
woraus: откуда? 
wovon: из чего?, от чего?, о чем?
wurm: червь
wöchentlich: еженедельно
würstchen: сосискв
würzig: пряный
#yoga
#yogamatte
zahnarzt: дантист
#zahnschmerzen
Zahnspange: брекеты (на зубах)
zauberer: волшебник
zebra: зебра
zeh: палец на ноге
zeichentrickfilm: мультфильм
zellten: ставить палатку/жить в палатке
zerbrochen: сломанный
zerknittert: смятый
zerstört: разрушенный
zeugen:свидетельствовать, служить подтверждением
ziege: коза 
zig: тысячи (неопределенное большое число)
zudecken: прикрывать, укрывать, накрывать, застилать
#zugtür
zunge: язык(орган), язычок(обуви)
zurückbekommen: получать ч-л назад
zurückzahlen: отдавать долг, платить/выплачивать
zusammenarbeiten: работать совместно
#zweimal
#zweiten
#zypern
#zürich
#ägypten
öffnungszeiten: часы работы 
#österreich
überfallen: нападать, атаковатьzunächst
übergeben: перепоручать, с sich - блевать, капитулировать
#überglücklich
überschwemmen: затапливать
überschwemmung: затопление
überstunden: переработка, сверхурочные
übung: упражнение
